24시간 내내|24 hours a day/24 heures sur 24&n일 마다|every n days/tous les n jours&만일의 경우에|at the worst/au pire&수년간|for years/pendant des années&를 이유로
를 근거로|on the grounds that/au motif que&가급적이면
되도록|preferably/de préférence&될 수 있는 한|as far as possible/autant que possible&얼마 안 되어|shortly/depuis peu&얼마 전에|right before/juste avant&얼마 후에|right after/juste après&가까스로
간신히|narrowly/de justesse&가끔
때때로
간간이
이따금|sometimes/parfois&종종
왕왕|from time to time/de temps en temps&만큼|as much as/autant ... que&가만히
하는 것 없이
아무것도 안하면서|doing nothing/sans rien faire&간단히
단순히|simply/simplement&간단히 말해서|in short/en deux mots&간접적으로|indirectly/indirectement&갈기갈기
너덜너덜|in tatters/en lambeaux&갑자기
갑작스럽게
대뜸
불쑥
급격히
돌연히|suddenly/soudain&느닷없이|abruptly/brusquement&강요로
강제로
억지로|by force/par force&하물며 는 아니다|even less/encore moins&마지못해
어쩔 수 없이|reluctantly/malgré soi&강하게
세게
세차게|forcefully/fort&같은 날에|to the day/jour pour jour&같이
똑같이
마찬가지로
매한가지로|likewise/de même&이맘때|about this time/à cette époque&동일[동등]하게
대등[균등]하게|equally/également&거듭
되풀이하여|over and over/à plusieurs reprises&반복적으로|repeatedly/de manière répétitive&거리낌 없이
가감[기탄] 없이|without reservation/sans réserve&거의|almost/presque&약
대략|about/environ&어림잡아|approximately/approximativement&거의 않게
별로 않게|hardly/à peine&겉으로는
보기에는
언뜻 보아|apparently/apparemment&겨우
고작
기껏해야|just/à peine&격년으로|every other year/tous les deux ans&(예상한 바대로) 결국|finally/enfin&(예상치 못하게) 결국|finally/finalement&끝내
마침내|in the end/à la fin&결코
결단코|never/jamais&게다가
뿐만 아니라|moreover/en plus&심지어|even/voire&또한|also/de plus&계속
연속으로|continuously/continuellement&끊임없이|ceaselessly/sans cesse&연이어|in a row/d'affilée&줄곧[내내]|without stopping/sans discontinuer&고루고루
공정[공평]하게|equitably/équitablement&곧|soon/bientôt&곧장
곧바로|right away/aussitôt&조만간
머지않아|in the near future/prochainement&얼마 있으면
얼마 안 있어|a bit later/d'ici peu&교대로|in rotation/par roulement&괜히
사소한 일로
아무것도 아닌 일로|for nothing/pour rien&귀납적으로
경험적으로|a posteriori/a posteriori&그간
그 동안|in the meantime/entre-temps&그냥
그저
단지|just/juste&오직
오로지|only/ne ... que&그 다음에
곧이어
뒤이어|then/ensuite&그래서
그럼
그러면|so/alors&하여
이에|to this end/à cet effet&따라서
그러므로|thus/de ce fait&그렇다면|if so/si oui&그렇기 때문에|hence/d'où&그러니까|anyway/enfin&도처에|everywhere/partout&그럼에도 불구하고
그렇기는 해도
그렇기는 하지만|nevertheless/toutefois&그 대신에
그 대가로|in return/en retour&그때부터|since then/dès lors&그래도
적어도|at least/au moins&(역접을 동반하여)
그러나
다만
그렇지만|all the same/tout de même&그런데
그나저나|anyway/au fait&참
그건 그렇고|apart from that/sinon&그렇다고 해서|be that as it may/pour autant&그렇지 않으면
안 그러면|otherwise/sinon&및|as well as/ainsi que&...도 ...도|as much ... as .../tant ... que ...&...에다 ...까지|and even/et même&그리고 나서
그러고는
그런 다음|and then/et ensuite&그리 잘
그렇게 잘|so well/si bien que ça&그보다 정도는 덜하지만|to a lesser extent/dans une moindre mesure&그저 만 하다면|provided/pourvu que&조금이라도 하다면|in the event that/pour peu que&그토록
그처럼
그리도
그렇게나
그 정도로|so much/autant&(형용사, 부사만을 수식)
그토록
그처럼
그리도
그렇게나
그 정도로|so/si&그 결과로|as a result/par conséquent&그 때
그땐
그때는|at the time/à ce moment&그 당시
그 무렵|then/alors&그 때까지|until then/jusqu'alors&그 어느때보다 더|more than ever/plus que jamais&그 중에서도|among others/entre autres&글쎄|and yet/et encore&금새
얼마 지나지 않아|shortly after/peu après&기꺼이|with pleasure/avec plaisir&기본값으로
디폴트로|by default/par défaut&깊게
깊이|profoundly/profondément&까마득히
끝도 없이|as far as the eye can see/à perte de vue&꼭|absolutely/absolument&필히
반드시|necessarily/nécessairement&기어코|at all costs/coûte que coûte&어떻게든
어떻게 해서든|no matter what/à tout prix&끝까지|to the end/jusqu'au bout&나날이
날로|from day to day/de jour en jour&나름대로|in one's own way/à sa manière&나중에
이따가|later/plus tard&언젠가
이 다음에|someday/un jour&냐에 따라|whether/selon que&논리적으로|logically/logiquement&눈 깜짝할 사이에
순식간에
일순간에|in the blink of an eye/d'un coup d'oeil&눈에 띄지 않게
은밀히
비밀리에|secretly/secrètement&늘 그랬듯이|as always/comme toujours&다른 곳에|elsewhere/ailleurs&다른 방법으로|some other way/autrement&다시|again/encore&재차|once again/de nouveau&새로이|once again/à nouveau&단계적으로|step by step/d'étape en étape&단도직입적으로
돌려 말하지 않고|straightforwardly/sans détour&단연
단연코|by far/de loin&달리 말하자면|in other words/autrement dit&하는 한편|while/tandis que&방금
금방|a moment ago/il y a un moment&조금 전에|a little while ago/il y a pas longtemps&당장
즉각
즉시|right now/de suite&대개
대부분
대다수|mostly/pour la plupart&대대적으로
대거|massively/massivement&대부분의 경우에|in most of the time/dans la plupart du temps&대충
대강|roughly/en gros&더더욱
더욱더|more and more/davantage&더 많이
훨씬 더|even more/d'autant plus&덜
적게|less/moins&도
또한
역시|also/aussi&(보통 단독절로)
도
또한
역시|too/de même&동시에
한꺼번에|at once/à la fois&뒤로|back/en arrière&따로|apart/à part&딱|squarely/carrément&혹은|or else/ou encore&(시간상)
막|just/juste&막판에
막바지에|at the last minute/à la dernière minute&만일을 대비해서|just in case/au cas où&만장일치로|unanimously/à l'unanimité&많이|very much/beaucoup&꽤|quite/pas mal&제법|rather/assez&상당히|considerably/considérablement&맘껏
마음껏
마음대로|as much as one want/à volonté&맞게
알맞게
적절[적정]하게
적합[적당]하게|properly/convenablement&아주|highly/tout&너무|too/trop&무척
몹시|so much/tant&(형용사, 부사만을 수식)
무척
몹시|so/si&먼저
우선|first/d'abord&무엇보다도|first and foremost/avant tout&며칠 후|several days later/quelques jours plus tard&며칠 간
며칠 내에
수일 내에|in several days/en quelques jours&마침|just/justement&모든 시기를 통틀어|of all time/de tous les temps&역사상|of its history/de son histoire&몰래
숨어서|secretly/en cachette&무작위로|randomly/au hasard&무조건|unconditionally/inconditionnellement&미리|in advance/par avance&미친듯이
미치도록|like crazy/à la folie&바로
정확히|precisely/précisément&반대로
거꾸로|upside down/à l'envers&반면에|on the other hand/en revanche&보기보다|than it seems/qu'il n'y paraît&보아하니|it seems/à ce qu'il paraît&본능적으로|instinctively/instinctivement&부득이
불가피하게
하는 수 없이|inevitably/inévitablement&분명히
명백[엄연]히
명확[명료]히|evidently/évidemment&비공개로|in camera/à huis clos&비교적|comparatively/comparativement&(형용사, 부사만을 수식하여) 비교적|rather/plutôt&비할 데 없이
더할 나위 없이|incomparably/incomparablement&급히
서둘러|hurriedly/en hâte&사각으로
네모지게|squarely/carrément&사실|actually/en fait&실제적으로|practically/pratiquement&살금살금|stealthily/à pas de loup&서로|each other/l'un l'autre&설령 할지라도
설사 할지라도|even if/quand bien même&손에 손잡고
서로 팔짱을 끼고|hand in hand/bras dessus bras dessous&성대하게
거창하게|with great pomp/en grande pompe&성큼|with large steps/à grand pas&세월이 흐르면서|over the years/au fil des années&소문에 의하면
사람들이 그러는데|by all accounts/à ce que l'on dit&솔직히 말하면|honestly/honnêtement&사실대로 말하면|to tell the truth/à vrai dire&수단과 방법을 가리지 않고|by any means/par n'importe quel moyen&시간당|per hour/à l'heure&시간이 지나면서|with time/avec le temps&시험적으로
시험삼아|on trial/à l'essai&실로
실제로|actually/effectivement&실수로
의도치 않게|accidentally/sans faire exprès&무심코
본의 아니게|involuntarily/involontairement&쌍방에서
양측[양쪽]에서|on both sides/de part et d'autre&아까부터|since a while ago/depuis un moment&아낌 없이|without reservation/sans réserve&아마
아마도|maybe/peut-être&어쩌면|probably/probablement&필경
십중팔구|in all likelihood/vraisemblablement&아무 일도 없었던 것처럼|as if nothing had happened/comme si de rien n'était&아무도 모르게|without person knowing/à l'insu de personne&아무렇게나|anyhow/n'importe comment&아무리 늦어도|at the latest/au plus tard&앞으로
전방으로|forward/en avant&아직
이제껏
여지껏|yet/encore&약간
좀
조금|a little/un peu&다소|somewhat/plus ou moins&어느 정도는|to a certain extent/dans une certaine mesure&어딘가에|somewhere/quelque part&어떻게 보면은
어떤 면에서는|in a way/en quelque sorte&어쨌든
아무튼
하여튼|anyway/en tout cas&어쨌든 간에
어찌됐든 간에|be that as it may/quoi qu'il en soit&어차피|anyway/de toute façon&언제든지|anytime/n'importe quand&얼마나|how much/à quel point&에도 불구하고
인데도
일지라도
이긴 하지만|though/bien que&(비록)
에도 불구하고
인데도
일지라도
이긴 하지만|even if/même si&여기저기
군데군데
듬성듬성|here and there/de part en part&여러 번|many times/plusieurs fois&연역적으로
선험적으로|a priori/a priori&영원히|forever/pour toujours&언제까지나|forever and ever/à tout jamais&오래 전에
옛날[예전]에|a long time ago/autrefois&언젠가|once/une fois&오랫 동안
오래전부터|for a long time/depuis longtemps&오히려
도리어
차라리|rather/plutôt&요약하자면|in summary/pour résumer&완전히|completely/complètement&완벽히|perfectly/parfaitement&철저히|thoroughly/fondamentalement&외워서|by heart/par cœur&원격으로|remotely/à distance&우연히
뜻하지 않게|by chance/par hasard&유창하게|fluently/couramment&의 경우에
할 시에|in case/au cas où&원래|usually/d'habitude&이를 위하여|to this end/à cette fin&이렇게|like this/comme ça&이런 식으로|in this manner/de cette manière&이를테면
말하자면|so to speak/pour ainsi dire&이미
벌써|already/déjà&이번에는|this time/cette fois-ci&이번만
이번을 마지막으로|once and for all/une fois pour toutes&이제부터
앞으로는|from now on/désormais&인데도|while/lorsque&일단
당분간
당장은|for the moment/pour le moment&일대일로|one to one/seul à seul&일반적으로
보통|normally/normalement&일부러
고의로|on purpose/exprès&일찌기
이제껏
지금껏|ever/jamais&일찍|early/tôt&자기도 모르게
부지불식간|without one's knowledge/à son insu&자세히|in detail/en détail&조목조목|point by point/point par point&자주
흔히|often/souvent&빈번히|frequently/fréquemment&잘못|wrong/mal&틀리게
그릇되게|falsely/faussement&잠깐
잠시|for a moment/un instant&재빨리
허겁지겁
부랴부랴|in a rush/à fond les ballons&적기에
적절한 때에
시의적절하게|in due course/en temps opportun&전년 대비|from one year to the next/d'une année sur l'autre&전방위적으로
사방에서
사방으로|left and right/tous azimuts&전속력으로
전력을 다해|at full speed/à toute vitesse&전부
전적으로|entirely/entièrement&전에
이전[일전]에|before/avant&예전에|formerly/anciennement&사전에|in advance/préalablement&전혀|not at all/pas du tout&조금[추호]도|not in the least/aucunement&점점
갈수록|more and more/de plus en plus&정말로|really/vraiment&되게|so much/quand même&겁나
존나|as shit/à chier&정녕
진정으로|for real/pour de bon&정면으로|head on/de plein fouet&정성껏
정성스레|carefully/soigneusement&제때에
정시[정각]에|on time/à l'heure&조차도|even/même&조금씩
하나씩|little by little/petit à petit&조속한 시일 내로|as soon as possible/dans les plus brefs délais&좋든 싫든 간에|like it or not/bon gré mal gré&주로|mainly/principalement&특히|especially/particulièrement&즉석에서|on the spot/sur-le-champ&현재|at present/à présent&지나치게|to excess/à l'excès&지체없이|without further delay/sans plus tarder&진짜로|really/réellement&참으로
참말로|truly/franchement&진실로|truly/véritablement&질세라
앞다투어|to outdo each other/à qui mieux mieux&짧게|shortly/court&간략[짤막]하게|briefly/brièvement&쭉
바로
똑바로|straight/droit&차례대로
번갈아서
돌아가면서|in turn/à tour de rôle&처럼
만큼|like/comme&처음으로|for the first time/pour la première fois&첫째
일차적으로|first/premièrement&최근에|recently/récemment&갓
막|freshly/fraîchement&요즘
근래|these days/ces jours-ci&최대|at maximum/au maximum&초에
초기에|at the beginning of/au début de&타고나기를
선천적으로
천성[천부]적으로|naturally/naturellement&충분히|enough/assez&특히 하니
이니 만큼|especially as/d'autant plus que&틀림없이|undoubtedly/sans aucun doute&편히|at ease/à l'aise&평균적으로|on average/en moyenne&포함하여|including/y compris&필사적으로
결사적으로|tooth and nail/bec et ongles&하는데|while/tandis que&하는 동안에
하는 사이에|while/lorsque&하는 반면에
하는 데 반해
이기는 하지만|while/alors que&하는 조건으로|on condition that/à condition que&하루 종일|all day/toute la journée&하룻밤 사이에|overnight/du jour au lendemain&하는 한|as long as/aussi longtemps que&혹시라도
만약에 말인데|if ... by any chance/si jamais&하자마자
하는 대로|as soon as/dès que&하지 않으면
하지 않는 한|unless/à moins que&하찮은 일로
고작 이런 일로|for so little/pour si peu&한 방울 한 방울|drop by drop/goutte à goutte&한 번에
단번에
단박에|at the first attempt/du premier coup&한편|meanwhile/d'un autre côté&할 때마다|whenever/chaque fois que&할부로|by installments/à tempérament&할지 모르니
할까 봐|fearing that/de peur que&합쳐서|in total/au total&항상|always/toujours&매사|in all circumstances/en toutes circonstances&매번
그때마다|every time/chaque fois&헛되이|vainly/vainement&혹시|by any chance/par hasard&혼자 힘으로
자력으로|by oneself/à lui seul&확실히
확연히|surely/sûrement&후에
이후에|after/après&가 끝나고|at the end of/à l'issue de&가 없으면
가 없어서
가 없는 한|without/sans&가 적어서
가 부족해서
가 모자라서|for lack of/par manque de&까지|until/jusqu'à&까지는 아니더라도|if not/sinon&는 차치하더라도|aside from/sans compter&대신|instead of/au lieu de&때문에|because of/à cause de&덕분에|thank to/grâce à&인해서
함으로써|by/à force de&로부터 안전하게|safe from/à l'abri de&로서|as/en tant que&를 가정하면|suppose/supposé&를 건너뛰어
를 거치지 않고|over/par-dessus de&를 고려해서
를 생각해서|given/compte tenu de&를 기리며
에게 경의를 표하며|in homage to/en hommage à&를 따라서
를 본받아|following one's example/à l'exemple de&를 무시하고|with no regard for/au mépris de&를 벗어나|out of/hors&를 볼 때|in view of/au regard de&를 비추어 볼 때|in light of/à la lumière de&를 빼고
를 제외하고|except/sauf&를 하려고
를 하도록|in order to/afin de&를 위하여
를 위해서|for/pour&를 위한|for/pour&(누군가) 를 위한|for/à l'intention de&(무언가) 를 위한|for/en vue de&를 이용하여|using/au moyen de&를 이유로|on grounds of/pour raison de&를 통해
를 거쳐
를 가로질러|through/à travers&를 매개로|through/par le biais de&를 경유하여|by way of/en passant par&를 핑계로
를 기화로|under favour of/en faveur de&를 구실삼아|under the pretext of/sous le couvert de&모두 합해서
다 합쳐서|in all/en tout&부터|from/depuis&부로|as of/à compter de&뿐만 아니라|as well as/en plus de&에 걸쳐|over/sur&(무언가 또는 누군가)
에 관하여
에 관련하여
에 대하여|about/sur&(무언가)
에 관하여
에 관련하여
에 대하여|regarding/à propos de&에 관해서는
에 대해서는|when it comes to/quant à&에 있어서는|as far as ... is concerned/en ce qui concerne&에 대비하여|in readiness for/en prévision de&에 따라서
에 맞게
에 알맞게|according to/suivant&에 의하면|according to/selon&에 비하여
에 비교하여|compared to/en comparaison de&에 상관없이|regardless of/quel que soit&에 유리하게
의 이익이 되도록|in favour of/en faveur de&에 의해서
에 의하여|by virtue of/en vertu de&에 좌우되는
에 휘둘리는|at the mercy of/à la merci de&연안에서
앞바다에서|off the coast of/au large de&와 같은 높이에
와 동일선상에|to the height of/à la hauteur de&와 같이
처럼
듯이|as/comme&(예시를 들며)
와 같이
처럼
듯이|such as/tel que&와 다른
이 아닌 다른|unlike/autre que&와 마주보고
와 대면하여|face to face with/vis-à-vis de&와 마찬가지로
와 다름없이|as well as/de même que&와는 달리|unlike/à la différence de&으로 보았을 때
인 관점[차원]에서|from a ... point of view/du point de vue&의 가까이에|near/à proximité de&의 근처[주위]에|around/autour de&의 가운데에
의 한복판에|in the middle of/au milieu de&의 경우에|in case of/en cas de&의 끝에|at the end of/au bout de&의 가장자리에|by/au bord de&의 도움으로|with the help of/à l'aide de&의 맞은편에
의 건너편에|opposite/vis-à-vis de&그래도|but still/mais bon&의 면에서|in terms of/sur le plan de&의 밖에
의 외부에|outside/hors de&의 보호 아래
의 비호 아래|covered by/sous le couvert de&의 수준에
의 차원[높이]에|to the level of/au niveau de&의 아래에|below/en dessous de&의 옆에
의 곁에
의 편에|beside/à côté de&의 위로
를 넘어서|over/par-dessus de&의 위에|above/au-dessus de&의 이름으로|in the name of/au nom de&의 일환으로
의 범위 내에서|within the scope of/dans le cadre de&의 표시로|as a sign of/en signe de&의 한복판에
한창 때에|in the middle of/en plein&이내에
만에|within/en moins de&이외에도
말고도|besides/outre&이하의|below/en dessous de&조차 하지 않고|without/sans pour autant&중간에
도중에|in the middle of/au milieu de&(시간 상) 중에|during/lors de&(시간 상) 동안[사이]에|during/pendant&(장소 상) 
중에
사이에|among/parmi&지금부터 까지|from now until/d'ici à&하고 싶지 않다면|or be subject to/sous peine de&하기까지
할 정도로|to the point of/au point de&하면서도|while/tout en&한테서
측에서|from/de la part de&할지도 모르지만
를 각오하고
할 것을 무릅쓰고|at the risk of/au risque de&할 때에
할 시에|during/lors de&후에|after/après&2개 국어를 하는|bilingual/bilingue&n 자릿수의|in n digits/à n chiffres&가격 변동이 심한|volatile/volatil&가까운|close/proche&인접[근접]한|adjacent/adjacent&가난한
빈곤한|poor/pauvre&가득한|full/plein&꽉 찬|filled/rempli&만원인|full/complet&가리키는
지목[지칭]하는|indicative/indicatif&가만히 있는|quiet/tranquille&가벼운
경(輕)|light/léger&가부장제의|patriarchal/patriarcal&가상의|virtual/virtuel&가공의|fictional/fictif&가스의|gas/gazier&가시가 있는|thorny/épineux&가족의
가정의|family/familial&가짜의|fake/faux&가파른|steep/raide&비탈진
경사진|on a slope/en pente&가혹한
혹독한|harsh/rude&각각의
각자의|each/chacun&각기의|respective/respectif&각종의
각양각색의
여러 가지의|a variety of/une variété de&간헐적인|intermittent/intermittent&갈팡질팡하는
이러지도 저러지도 못하는|bumbling/tiraillé&감동한|moved/ému&감상적인|sentimental/sentimental&감정적인
정서적인|emotional/émotionnel&갑작스러운
급작스러운
급격한
돌연한|sudden/soudain&느닷없는|abrupt/brusque&강요된
강제된
억지의|forced/forcé&의무가 있는
할 수 밖에 없는
하지 않을 수 없는|obliged/obligé&마지못한
어쩔 수 없는|compulsory/contraint&강한
굳센
세찬|strong/fort&강력[강렬]한|powerful/puissant&갖춘|having/muni&(장비가)
장착[설비]된
구비[비치]된|equipped/équipé&(가구가)
장착[설비]된
구비[비치]된|furnished/meublé&개개의
개별의|individual/individuel&객관적인|objectif/objective&거동이 불편한|with reduced mobility/à mobilité réduite&거만한
오만[방자]한|arrogant/arrogant&거의 없는|little/peu&(관념적으로)
거친|touch/rude&사나운
맹렬한|fierce/féroce&(실체적으로)
거친|rough/grossier&건조한|dry/sec&메마른|arid/aride&겁많은|fearful/peureux&소심한|timid/timide&게걸스러운|greedy/avide&게으른|lazy/paresseux&나태한|indolent/indolent&격한
격렬한|intense/intense&격동의|stormy/orageux&결속된
연대하는|united/solidaire&결심이 선
다짐한|decided/décidé&결여된
결핍된|deficient/déficient&결정적인|decisive/décisif&확정적인|determining/déterminant&불가역적인
돌이킬 수 없는|irrevocable/irrévocable&겸손한|modest/modeste&겸허한|humble/humble&경멸적인|pejorative/péjoratif&경솔한|imprudent/imprudent&부주의한
조심성 없는|indiscreet/indiscret&계급의
서열[위계]의|hierarchical/hiérarchique&계절의|seasonal/saisonnier&(수준 따위가)
고급의|advanced/avancé&(품질 따위가)
고급의|of high qualities/de hautes qualités&고대의|antique/antique&고립된
외딴|isolated/isolé&고성능의
고효율의|high-performance/performant&고아의|orphan/orphelin&고의적인
의도적인|voluntary/volontaire&고의가 아닌
본의 아닌|involuntary/involontaire&고장난|out of order/en panne&고정된|fixed/fixé&고집센|obstinate/obstiné&완고한|stubborn/rigide&고통스러운|painful/douloureux&곱슬곱슬한|curly/bouclé&공간의|spatial/spatial&공격적인|aggressive/agressif&공기의
공중의|air/aérien&공동의
공통의|common/commun&합동의|joint/conjoint&공들인
공들여 만든|elaborate/élaboré&공범의|accomplice/complice&공적인
공공의|public/public&공개된|public/public&공식적인|formal/formel&공정한
공평한|fair/juste&공명정대한
불편부당한|impartial/impartial&과격한
급진적인|radical/radical&과일의|fruit/fruitier&과학적인|scientific/scientifique&과한
과도한
지나친|excessive/excessif&관광의|touristic/touristique&관련된|relevant/concerné&관세의
세관의|customs/douanier&눈길을 끄는|eye-catching/accrocheur&광고의|advertising/publicitaire&광물의|mineral/minéral&교육적인|instructive/instructif&교훈적인|moral/moral&교활한
간사한|crafty/futé&약삭빠른|cunning/rusé&구름이 낀|cloudy/nuageux&구식의
뒤떨어진|outdated/dépassé&케케묵은|archaic/archaïque&낡아빠진
구닥다리의|old-fashioned/désuet&국가의
국민의|national/national&국내의|internal/intérieur&군대의
군부의|military/militaire&굳은|firm/ferme&굴복한
순종적인
복종하는|obedient/obéissant&굴복하지 않는
순종적이지 않은
복종하지 않는|disobedient/désobéissant&굴하지 않는
불굴의|indomitable/indompté&굵은
두꺼운|thick/épais&굶주린|starving/affamé&권위적인|authoritarian/autoritaire&권장되는
권고되는|recommended/recommandé&귀먹은|deaf/sourd&귀속된|attributed/dévolu&그럴듯한|plausible/plausible&그저그런
좋지도 나쁘지도 않은|neither good nor bad/ni bien ni mal&근면한|hard-working/travailleur&성실한|faithfu/fidèle&부지런한|diligent/diligent&근본적인
본질적인|fundamental/fondamental&금기시되는
터부시되는|taboo/tabou&금융의|financial/financier&금전적인|pecuniary/pécuniaire&기계적인|mechanical/mécanique&기다리는
대기 중인|pending/en attente&기독교의
기독교인의|Christian/chrétien&기록적인|record/record&기름진|greasy/gras&기발한
재치 있는|ingenious/ingénieux&기분 나쁘게 하는
불쾌한|disagreeable/désagréable&기분 좋게 하는
쾌적한|pleasant/plaisant&기쁜|glad/content&(매우) 기쁜|delighted/ravi&기술적인|technical/technique&기운을 주는|tonic/tonique&기적적인
경이로운|miraculous/miraculeux&기존의|existing/existant&기죽은
좌절[낙담]한|discouraged/découragé&의기소침한
우울한|depressed/déprimé&기혼의
결혼한|married/marié&기후의|climatic/climatique&기상의|meteorological/météorologique&긴장한|tensioned/tendu&길을 잃은|lost/perdu&(성격이)
까다로운|demanding/exigeant&깨끗한
깔끔[청결]한|clean/propre&순수한|pure/pur&(빛, 기계 따위가)
꺼진|off/éteint&(화재가)
꺼진|out/éteint&꽉 끼는|tight/serré&끈질긴
끈기있는|tenacious/tenace&지칠 줄 모르는|tireless/infatigable&끔찍한
참혹한|terrible/terrible&나무가 우거진
숲이 우거진|wooded/boisé&나은|better/mieux&나타내는|representative/représentatif&낙천적인|optimistic/optimiste&낙후된|disadvantaged/défavorisé&난폭한
폭력적인|violent/violent&남은
남아 있는|remaining/restant&여분의|spare/de rechange&남짓한
조금 넘은|a little more than/un peu plus de&낮은
저(低)|low/bas&낮은 지위의
신분이 낮은|low-level/de bas étage&내성적인|introverted/introverti&내재적인|inherent/inhérent&냉동의|frozen/surgelé&널리 퍼진
널리 번진|widespread/répandu&넓은|large/large&널찍한|spacious/spacieux&광대한|vast/vaste&노조의|trade union/syndical&녹색의|green/vert&논외의
주제를 벗어난|off-topic/hors sujet&논쟁의|polemical/polémique&논란의|controversial/controversé&놀라운|surprising/étonnant&(믿을 수 없을 만큼) 놀라운|incredile/incroyable&쩌는
지리는|astonishing/époustouflant&대박인|great/génial&경이로운|phenomenal/phénoménal&감탄스러운|enthralling/émerveillant&경악스러운|stupefying/stupéfiant&놀라는
감탄하는|admiring/admiratif&놀리는|mocking/moqueur&농산물 가공업의|food-processing/agroalimentaire&농업의|agricultural/agricole&높은
고(高)|high/haut&(무언가 보다)
낮은
저(低)|lower/inférieur&(무언가 보다)
높은
고(高)|higher/supérieur&누운|lying/allongé&눈에 띄는|marked/marqué&현저한|notable/notable&두드러진|salient/saillant&느린|slow/lent&느슨한
헐거운
헐렁한|loose/lâche&능한
능숙한|skilful/adroit&숙련된|practised/exercé&경험 있는|experienced/expérimenté&솜씨 좋은|handy/habile&늦은|late/en retard&다가오는
다가올|forthcoming/à venir&다국간의|multilateral/multilatéral&다른
상이[판이]한|different/différent&다양한
분분한
다채로운|various/varié&다용도의|versatile/à divers usages&다운
잘 맞는
걸 맞는|worthy/digne&다음의|next/prochain&(특히 글 따위에서) 다음의|following/suivant&단
달콤[달달]한|sweet/doux&(설탕을 넣어)
단
달콤[달달]한|sugary/sucré&단단한
딱딱한|hard/dur&단호한
확고한|firm/ferme&강경한|hard-line/dur&달아나는
도망가는|fugitive/fugitif&닮은
비슷한
유사한|similar/similaire&당연한|normal/normal&당장의
즉각[즉시]의|immediate/immédiat&당황한
당혹스러운
난처[곤란]한
곤경에 처한|embarrassed/embarrassé&어이없는
어리둥절한|confounded/confondu&대규모의|large-scale/à grande échelle&대기의|atmospheric/atmosphérique&대다수의
대부분의|most/la plupart de&상당 부분의|a large party of/une bonne partie de&대단한|extraordinary/extraordinaire&굉장한|formidable/formidable&주목[괄목]할 만한|remarkable/remarquable&대대적인|massive/massif&대량의
다량의|a large quantity of/une grande quantité de&대머리의|bald/chauve&대중적인|popular/populaire&대표하는|representative/représentatif&더러운|dirty/sale&더운|hot/shaud&무더운|torrid/torride&덧없는|ephemeral/éphémère&덮인
투성이인|covered/couvert&도덕의|moral/moral&도로의|road/routier&도의
도립의|prefectural/préfectoral&독거의
혼자 사는|solitary/solitaire&독립적인|independent/indépendant&독재의
전제의|autocratic/autocratique&독창적인
참신한|original/original&(술, 냄새 따위가) 독한|strong/capiteux&돌아온
컴백한|back/de retour&돌연변이의|mutant/mutant&돌출한
튀어나온|projecting/saillant&동맹의
연합의|ally/allié&동시대의|contemporary/contemporain&동질의
균질의|homogeneous/homogène&동쪽의|eastern/d'Est&동양[동방]의|oriental/oriental&되풀이되는|repeated/répétitif&재발[회귀]하는|recurrent/récurrent&두뇌의|cerebral/cérébral&두려워하는
무서워하는|afraid/craintif&두렵게 하는
무섭게 하는
무시무시한|terrible/terrible&둘러싸인
에워싸인|surrounded/entouré&드문
희귀한|rare/rare&들린
씌인
홀린|possessed/possédé&뒤의
후방의|back/arrière&떠도는
방황[방랑]하는|wandering/errant&돌아다니는
배회하는|roaming/vagabond&따뜻한|warm/chaud&미지근한|tepid/tiède&떼인
떼어진|detached/détaché&같은
똑같은
마찬가지인
매한가지인|same/même&동일[동등]한
대등[균등]한|equal/égal&똑똑한
지적인
지혜로운|intelligent/intelligent&현명[총명]한|wise/sage&영리[영악]한|clever/débrouillard&박식한
아는 것이 많은|knowledgeable/savant&뚜렷한|distinct/distinct&뚱뚱한
살찐|fat/gros&뛰어난
탁월한|excellent/excellent&특출난
걸출한|eminent/éminent&훌륭한|exceptional/exceptionnel&비범한
보통 이상의|out of the common/hors du commun&비할 데 없는|incomparable/incomparable&뜻밖의|unexpected/inattendu&예상치 못한|unpredictable/imprévu&마실 수 있는
음용 가능한|drinkable/potable&마주한
직면[대면]해 있는|confronted/confronté&만료된
만기가 된
기한이 지난|expired/périmé&만성적인|chronic/chronique&마음이 가는
내키는
구미가 당기는|tempting/tentant&(무언가가 또는 누군가가)
만족한
충족된|satisfied/satisfait&(누군가가)
만족한
충족된|content/content&만한
받아 마땅한|worthy/digne&많은|many/beaucoup de&(꽤) 많은|plenty of/pleins de&수많은|numerous/nombreux&셀 수 없이 많은|innumerable/innombrable&말도 안 되는
있을 수 없는
그럴 리 없는|inconceivable/inconcevable&맑은|clear/clair&맛없는|tasteless/fade&맛있는|tasty/bon&(매우) 맛있는|delicious/délicieux&먹음직한
식욕을 돋구는|appetising/appétissant&망가지기 쉬운
손상[파손]되기 쉬운|fragile/fragile&망설이는
주저하는|hesitant/hésitant&맞춤의
주문형의|customised/sur commande&매끄러운
매끈한|smooth/lisse&(고추를 넣어)
매운
양념된|spicy/pimenté&(향신료를 넣어)
매운
양념된|spicy/épicé&맹목적인|blind/aveugle&먼
머나먼|far/loin&멋진
멋있는|cool/cool&명목상의
이름뿐인|nominal/nominal&면제된|exempt/exempt&명망이 높은
위신[위엄]이 있는|prestigious/prestigieux&명시적인|explicit/explicite&명실상부한
이론의 여지가 없는|uncontested/incontesté&명쾌한
명석한|lucid/lucide&온
전|whole/tout&모범적인|model/modèle&모호한
애매한|ambiguous/ambigu&막연한|vague/vague&몰락한
쇠퇴한|ruined/ruiné&몰려 다니는
무리지어 다니는|in bands/en bande&못된
심술궂은|mean/mauvais&못생긴|ugly/moche&못난
볼품없는|graceless/disgracieux&못하는
부족한
모자란|bad/mauvais&무감각한|insensible/insensible&무거운|heavy/lourd&무게의
중량의|weight/pondéral&무결한
흠잡을 데 없는|impeccable/impeccable&무국적의
국적이 없는|stateless/apatride&무관심한
무심한|little attentive/peu regardant&무관한
관련 없는|unrelated/hors de propos&무기력한
기운 없는|inert/inerte&무능한
능력이 없는|incompetent/incompétent&무뚝뚝한|curt/sec&냉정한
쌀쌀맞은|cold/frais&퉁명스러운|brusque/brusque&무려
자그마치|no less than/pas moins de&무례한
실례되는|disrespectful/irrespectueux&버릇없는|impolite/impoli&건방진|insolent/insolent&무료의
공짜[무상]의|free/gratuit&무분별한
분별 없는|senseless/insensé&무사한|safe/sauf&무슨
어느
어떤|certain/certain&(의문문에서)
무슨
어느
어떤|which/quel&무익한|futile/futile&무자비한
무정[비정]한|heartless/impitoyable&무적의
꺾이지 않는|unbeatable/imbattable&무조건적인|unconditional/inconditionnel&무지한
무식한|ignorant/ignorant&무책임한|irresponsible/irresponsable&무형의
만질 수 없는|intangible/intangible&무효의|null/nul&문맥상의
맥락상의|contextual/contextuel&문맹의|illiterate/analphabète&문전성시의
붐비는
몰리는|crowded/suivi&물의|water/hydrique&물자보급의|logistics/logistique&물질적인|material/matériel&묽은
물기가 많은|liquid/liquide&미공개된|unreleased/inédit&비공개된|private/privé&미결의
미정의|undecided/indécis&미래의|future/futur&미묘한
교묘[절묘]한|subtle/subtil&미성년의|underage/mineur&미적인
심미적인|aesthetic/esthétique&미친|crazy/fou&민간의
민영의|private/privé&민간인의|civilian/civil&민족의|ethnic/ethnique&믿음직한
신뢰할 만한|reliable/fiable&밋밋한|flat/plat&단조로운|monotone/monotone&바깥의
외부[외면]의|exterior/extérieur&바다의
해양[해상]의|maritime/maritime&바람이 빠진|deflated/dégonflé&바람직한|preferable/préférable&바른|right/droit&맞는|correct/correct&바보같은|foolish/bête&멍청한|thick/nul&저능한|imbecile/imbécile&어리석은|stupid/stupide&얼간이 같은|idiotic/idiot&머저리 같은|dumb/con&(대개 사적인 업무로)
바쁜|busy/pris&(대개 공적인 업무로)
바쁜|occupied/occupé&바삭바삭한|crispy/croustillant&반대된
상반된|opposite/opposé&대조적인|contrasting/contrasté&반체제적인|subversive/subversif&반한
사랑하는|in love/amoureux&발열의
열이 나는|feverish/fébrile&밝은|bright/brillant&빛나는|luminous/lumineux&방사성의|radioactive/radioactif&(돈을 헤프게 써)
방탕한|prodigal/prodigue&배은망덕한
은혜를 모르는|ungrateful/ingrat&(누군가가) 배타적인|closed/fermé&(무언가가) 배타적인|exclusive/exclusif&버려진
버림받은|abandoned/abandonné&번영하는
번창[번성]하는|prosperous/prospère&융성[성행]하는|flourishing/florissant&벌거벗은
나체의
알몸의|naked/nu&법적인
법률의|legal/juridique&변덕스러운|capricious/capricieux&별것도 아닌
그만한
그까짓|not much/peu de&별다른|particular/particulier&별개[별도]의|separate/séparé&보람된
흐뭇한|gratifying/gratifiant&보람 없는
헛수고인|thankless/ingrat&보수적인|conservative/conservateur&보이는
가시적인|visible/visible&보조적인
보좌하는|assistant/assistant&본능적인|instinctive/instinctif&본래의|original/original&고유의|proper/propre&특유의|particular/particulier&봄의|spring/printanier&부끄러운
창피한
수치스러운|shameful/honteux&부담스러운|burdensome/pesant&부당한
부정한|unjust/injuste&부동산의|property/immobilier&부드러운|soft/moelleux&부러운
샘나게 하는|enviable/enviable&부러워하는
샘나는|envious/envieux&시기[질투]하는|jealous/jaloux&부유한
부자의|rich/riche&유복한|well-to-do/aisé&부은
부어오른|swollen/bouffi&부족의|tribal/tribal&부차적인
부수적인|secondary/secondaire&부대적인|incidental/incident&지엽적인|marginal/marginal&부패한
썩은
상한|corrupt/corrompu&북극의|arctic/arctique&분명한
명백[엄연]한
명확[명료]한|evident/évident&분별 있는
상식이 있는|sensible/sensé&분야별의
부문별의|sectoral/sectoriel&불가분의|indivisible/indivisible&불가피한
필연적인|inevitable/inévitable&불건전한|unhealthy/malsain&불공정한
불평등한|unfair/inéquitable&편파적인|partial/partial&불길한|sinister/sinistre&(제품 따위가)
불량의|defective/défectueux&불리한|unfavourable/défavorable&불만스러운
마음에 들지 않는|discontented/mécontent&불멸의
불사[불후]의|immortal/immortel&불법적인
위법한|illegal/illégal&불변의
변함없는|invariable/invariable&불참한
결석[결근]한|absent/absent&불쌍한|poor/pauvre&불우한|disadvantaged/défavorisé&비참한|miserable/misérable&가련한
가엾은|pitiful/piteux&불안정한|unstable/instable&불안한
걱정하는|worried/inquiet&초조해하는|impatient/impatient&마음 쓰는|preoccupied/préoccupé&근심하는
우려[염려]하는|concerned/angoissé&불임의|infertile/stérile&불충분한
모자란
부족한|not enough/pas assez&불투명한|opaque/opaque&(누군가가)
불편한
답답[거북]한|uncomfortable/mal à l'aise&(무언가가)
불편한
답답[거북]한|awkward/gênant&불평하는
투덜거리는|complaining/plaintif&불필요한
필요 없는|unnecessary/pas nécessaire&필요 이상의|superfluous/superflu&덧붙인|added/ajouté&첨부한|attached/joint&비겁한
비열한|cowardly/lâche&비관적인|pessimistic/pessimiste&비극적인|tragic/tragique&비꼬는
빈정거리는|ironic/ironique&비대칭의|asymmetric/asymétrique&비례하는|proportional/proportionnel&비만인|obese/obèse&비밀의
은밀한|secret/secret&기밀의|confidential/confidentiel&(지나치게) 비싼|prohibitive/prohibitif&값진
값비싼|costly/coûteux&고가의|high cost/de prix&비유적인|figurative/figuré&비판적인|critical/critique&비평의|criticism/critique&비현실적인|unreal/irréel&허구[소설]적인|fictional/romanesque&공상[몽상]적인|chimerical/chimérique&빈번한
흔히 일어나는|frequent/fréquent&빌린
꾼
차용한|borrowed/emprunté&급속한|rapid/rapide&신속한|prompt/prompt&재빠른
민첩한|agile/agile&(무언가에) 빠진|put/plongé&빠진
누락[생략]된|omitted/omis&빻은
분말의
가루로 된|ground/moulu&뻔뻔한|cheeky/effronté&뻣뻣한|stiff/raide&뿌리 깊은|rooted/enraciné&사교적인
사회[붙임]성이 있는|sociable/sociable&사막의|desert/désertique&사법의
법정의|judicial/judiciaire&사법의
민사의
민법상의|civil/civil&사설의
사립의|private/privé&사소한
무의미한
의미없는|insignificant/insignifiant&사실의|true/vrai&사실상의|virtual/véritable&사용되지 않는|not usable/hors d'usage&사적인|private/privé&사사로운
개인적인|personal/personnel&사치스러운
호화스러운|luxury/luxueux&산적한
산더미 같은|a mountain of/des tas de&살아있는|alive/vivant&생각에 잠긴|thinking/pensif&상급의
상등의|superior/supérieur&상당한|considerable/considérable&상설의
상비의|permanent/permanent&상속의
세습의|hereditary/héréditaire&올라가는
상승하는|rising/montant&상업의
무역의|commercial/commercial&상형적인
조형적인|figurative/figuratif&상호의
상호간의|mutual/mutuel&상호작용적인|interactive/interactif&생리적인|physiological/physiologique&생명의|vital/vital&생물학적인|biological/biologique&생식기의|genital/génital&서두의
도입의|introductory/introductif&서쪽의|western/d'Ouest&서양[서방]의|occidental/occidental&석유의|oil/pétrolier&선거의|electoral/électoral&설득력 있는
납득할 수 있는|convincing/convaincant&섬유의
직물의|textile/textile&성년의
성인의|adult/adulte&성숙한|mature/mature&세계적인|gloabl/mondial&지구적인|planetary/planétaire&세무의
세제의|tax/fiscal&세속적인
속세[현세]의|secular/laïque&세심한|attentive/attentif&꼼꼼한
용의주도한|meticulous/méticuleux&소박한
소소한|simple/simple&조촐한|modest/modeste&변변치 않은|humble/humble&검소[수수]한|without pretension/sans prétention&소중한
귀한
귀중한|precious/précieux&속이 빈|hollow/creux&손이 닿지 않는
거리가 미치지 않는|out of reach/hors de portée&솔직한|honest/honnête&속이 좁은
옹졸[편협]한|narrow-minded/étriqué&수익성이 좋은
돈벌이가 되는|lucrative/lucratif&수중의|aquatic/nautique&수백의|hundreds of/des centaines de&수소의|hydrogen/hydrogène&수용적인
잘 받아들이는|receptive/réceptif&수직의
세로의|vertical/vertical&수천의|thousands of/des milliers de&수평의
가로의|horizontal/horizontal&순간적인
잠깐의|momentary/momentané&순결한
처녀의|virgin/vierge&순진한
순진무구한|innocent/innocent&천진난만한|naive/naïf&숨이 가쁜|breathless/à bout de souffle&숲의
삼림의|forest/forestier&속상한|upset/affecté&구슬픈|mournful/morne&애석한|sorry/désolé&우울한
침울한|depressed/dépressif&가슴[마음] 아픈|hurt/peiné&습관적인|habitual/habituel&관습적인|customary/coutumier&관례적인|conventional/conventionnel&의례적인|ritual/rituel&일상[통상]적인|ordinary/ordinaire&시각의
광학의|optical/optique&시간의|hourly/horaire&시골의|rural/rural&시끄러운|noisy/bruyant&떠들썩한
소란스러운|tumultuous/tumultueux&시민의|civic/civil&시의
시립의|municipal/municipal&시의적절하지 않은
때아닌|untimely/inopportun&시의적절한
때맞춘|timely/opportun&시청각의|audiovisual/audiovisuel&시퍼런
검푸른|livid/livide&시행 중인|in force/en vigueur&식물의|plant/végétal&식물학의|botanic/botanique&신
시큼한|sour/aigre&신경의|nervous/nerveux&신비한
신비주의의|mystic/mystique&신중한|discreet/discret&조신한|circumspect/circonspect&조심스러운
조심성 있는|careful/prudent&사려깊은
생각이 깊은|thoughtful/réfléchi&신체의
육체의|bodily/corporel&실망한|disappointed/déçu&실전용의
실제 사용 가능한|operational/opérationnel&실제적인
실질적인|real/réel&실용적인|pragmatic/pragmatique&실체의
본체의|substantive/substantiel&실천적인|practical/pratique&실현 가능한|realisable/réalisable&심리적인|psychological/psychologique&심한|bad/gros&심각[극심]한|serious/grave&십자의|crucial/crucial&싼|cheap/pas cher&저가의|low-cost/bas de gamme&쌍방의
양측[양쪽]의|bilateral/bilatéral&쓰라린
뼈저린|bitter/amer&신랄한|acerbic/âcre&쓰이는|used/servant&쓴
씁쓸한|bitter/amer&쓸모없는
쓸데없는|useless/inutile&무용지물인|good for nothing/bon à rien&(글 따위에서)
아래의
하부[하단]의|following/suivant&(조직 따위에서)
아래의
하부[하단]의|inferior/inférieur&화려한|prestigious/prestigieux&예쁜|pretty/joli&아버지의
부친[부성]의|paternal/paternel&아끼는
알뜰한
절약[검약]하는|thrifty/économe&아픈
병든|sick/malade&악한
사악한|evil/méchant&안의
내부[내면]의|interior/intérieur&앉아 있는|sitting/assis&앉아서 일하는|sedentary/sédentaire&맞는
알맞은
적절[적정]한
적합[적당]한|proper/adapté&(가격 따위가)
맞는
알맞은
적절[적정]한
적합[적당]한|affordable/abordable&암묵적인|tacit/tacite&암흑의|dark/noire&앞의
전방의|front/avant&야만의
미개한|savage/sauvage&야생의|wild/sauvage&야심이 있는|ambitious/ambitieux&야외의
옥외의|outdoor/en plein air&약간의
조금의|a little of/un peu de&소수의|a minority of/une minorité de&소량의|a small quantity of/une faible quantité de&약한|weak/faible&병약한|sickly/maladif&취약한|vulnerable/vulnérable&허약한
나약[연약]한|fragile/fragile&얇은|thin/mince&가는
가느다란|fine/fin&양립할 수 있는
호환하는|compatible/compatible&양면성을 지닌|ambivalent/ambivalent&양심적인|conscientious/consciencieux&어긋나는
반하는
상반되는|contrary/contraire&모순되는|contradictory/contradictoire&어두운
캄캄한|dark/obscur&까다로운
복잡[난해]한|complicated/compliqué&어머니의
모친[모성]의|maternal/maternel&어안이 벙벙한|speechless/bouche bée&어색한
어설픈
서투른|clumsy/maladroit&어색한
서먹서먹한|awkward/gênant&부자연스러운|constrained/contraint&언어의|linguistic/linguistique&어지럽게 하는
현기증을 일으키는|dizzying/vertigineux&얼굴의
안면의|facial/facial&엄두도 못 낼|inconceivable/inconcevable&엄청난|immense/immense&엄한|severe/sévère&엄격[엄밀]한
엄중[엄정]한|rigid/rigide&없는|deprived/dépourvu&(빠뜨리어) 없는|missing/manquant&여러|several/plusieurs&몇몇|some/quelques&여러 언어를 하는|polyglot/polyglotte&역겨운|disgusting/dégoûtant&연간의
매년의|annual/annuel&연안의
해안의|coastal/côtier&열등한|inferior/inférieur&열렬한|fervent/fervent&열심인
열심히 하는
열의가 있는
열정[열성]적인|passionate/passionné&열의|thermal/thermique&영원한|eternal/éternel&무한한
끝없는|infinite/infini&한없는
하염없는|interminable/interminable&영구[항구]적인|permanent/permanent&옆의
측면의|side/latéral&예리한
날카로운|sharp/aigu&뾰족한|pointed/pointu&예민한
민감한|sensitive/sensible&예산의|budgetary/budgétaire&예비의|preliminary/préliminaire&예상할 수 있는
뻔한|predictable/prévisible&예의바른
정중[공손]한|polite/poli&통통한
오동통한
토실토실한|chubby/grassouillet&오래된
옛날의|old/vieux&온갖
오만가지의
모든 종류의|all kinds of/toutes sortes de&온건한
중도의|moderate/modéré&온순한
유순한|docile/docile&온화한|temperate/tempéré&옳은|right/droit&요리의|culinary/culinaire&와 같은|tant de/such&완곡한|indirect/indirect&완전한|complete/complet&완벽한|perfect/parfait&철저한|thorough/minutieux&왕의
왕실의|royal/royal&외교의|diplomatic/diplomatique&외국의|foreign/étranger&외로운|lonely/isolé&쓸쓸한
고독한|solitary/solitaire&외진
멀리 떨어진|remote/reculé&용감한|brave/courageux&용맹한|valiant/vaillant&우등한
우월한|superior/supérieur&우스꽝스러운|ridiculous/ridicule&우아한
고상한|elegant/élégant&기품[품위] 있는|distinguished/distingué&우연한
우발적인|accidental/accidentel&운명적인
숙명적인|fateful/fatidique&운이 좋은
행운의|lucky/chanceux&울퉁불퉁한|uneven/raboteux&웃긴
웃기는|funny/drôle&재밌는
재미있는|interesting/intéressant&원래 그대로의
원(原)|raw/premier&원자의|atomic/atomique&원치 않은
달갑지 않은|undesirable/indésirable&원칙적인|on principle/de principe&월간의|monthly/mensuel&(글 따위에서)
위의
상부[상단]의|above/au-dessus de&(조직 따위에서)
위의
상부[상단]의|superior/supérieur&위험한|dangerous/dangereux&험난한
위태로운|perilous/périlleux&유감스러운
안타까운|sorry/désolé&유기농의|biological/biologique&유능한
능력이 있는|skilful/compétent&유동성의|fluid/fluide&유료의|charged/payant&유리한
이로운|favourable/favorable&유망한
촉망 받는|promising/prometteur&유명한|famous/connu&저명한
명성이 높은|renowned/renommé&유연한|flexible/flexible&유익한|fruitful/fructueux&유일한|only/seul&유전의|genetic/génétique&유죄의
죄를 진|guilty/coupable&유행하는|in fashion/à la mode&유형의
만질 수 있는|tangible/tangible&유효한|valid/valide&육상의
지상의|terrestrial/terrestre&육식의|carnivorous/carnivore&으뜸가는|leading/de premier plan&은행의|bank/bancaire&음란한
외설적인|obscene/obscène&야한|naughty/coquin&음식의
식품의|food/alimentaire&응용의
적용의|applied/appliqué&의무적인|obligatory/obligatoire&의미있는
뜻 깊은
의미심장한|significative/significatif&의미하는
뜻 하는|meaning/significatif&의식하는
자각하는|conscious/conscient&의심스러운|suspect/suspect&의심하는
반신반의하는|doubtful/dubitatif&회의적인|sceptical/sceptique&의욕적인
동기부여된|motivated/motivé&의존하는|dependent/dépendant&의회의|parliamentary/parlementaire&이국적인|exotic/exotique&이기적인|selfish/égoïste&이도 저도 아닌|neither one nor the other/ni l'un ni l'autre&이러한|this kind of/ce genre de&이루는|composing/composant&형성[구성]하는|constituent/constitutif&이른|early/tôt&시기상조의|premature/prématuré&이상의|more than/plus que&이상한|bizarre/weird&별난|odd/drôle de&기이[기묘]한|peculiar/étrange&이성적인|rational/rationnel&이어지는
잇단
잇따르는|a suite of/une suite de&연이은|successive/successif&끊임 없는|incessant/incessant&계속되는
지속[연속]적인|continuous/continu&이용 가능한|available/à disposition&이웃의|neighbour/voisin&이주의|migratory/migratoire&이질적인
불균질의|heterogeneous/hétérogène&이하의|less than/moins que&이해할 수 없는|incomprehensible/incompréhensible&익명의|anonymous/anonyme&익숙한|familiar/habitué&(고기 따위가)
익은|cooked/cuit&(과일 혹은 곡물 따위가)
익은
여문|ripe/mûr&인간의|human/humain&인공의
인조[인위]적인|artificial/artificiel&인구통계의|demographic/démographique&인상적인
감명 깊은|impressive/impressionnant&인색한
구두쇠 같은|miserly/avare&인정받는|recognised/reconnu&인종의|racial/racial&일관된
조리 있는|coherent/cohérent&일련의|a series of/une série de&연쇄적인|a chain of/un enchaînement de&일반의
보통의|normal/normal&일반화된
만연한|generalised/généralisé&일방적인
편무적인|unilateral/unilatéral&일상의
매일[나날]의|daily/quotidien&일정한|constant/constant&꾸준한|regular/régulier&한결 같은|consistent/de tous les instants&일종의|a sort of/une sorte de&일치하는
부합하는
들어맞는|corresponding/correspondant&일회용의|disposable/jetable&임박한
목전의|imminent/imminent&임시적인
일시[잠정]적인|temporary/temporaire&임시변통의
땜빵의|makeshift/de circonstance&임신한|pregnant/enceinte&임의적인|facultative/facultatif&자의적인|arbitrary/arbitraire&입법의
입법부의|legislative/législatif&(옷을) 입은|dressed/habillé&자극적인|heady/capiteux&자발적인|voluntary/volontaire&자선의
구호의|charitable/caritatif&자세한
상세[세밀]한|detailed/détaillé&자신 있는|confident/confiant&자연스러운|natural/naturel&자유로운|free/libre&자유의
자유주의의|liberal/libéral&미세한|fine/fin&미미한|minimal/minime&자그마한
조그마한|minuscule/minuscule&잔인한
잔혹한|cruel/cruel&잘난 체 하는
거드럭거리는
거드름 피우는|pretentious/prétentieux&잘못된|wrong/mauvais&틀린
그른|false/faux&잘 썩는
상하기 쉬운
부패하기 쉬운|perishable/périssable&잘 짜여진
잘 계획된|well thought out/bien conçu&잘 하는|good/bon&잡종의|bastard/bâtard&성대한
거창한|magnificent/magnifique&장엄한
장중[장대]한|majestic/majestueux&웅대[웅장]한|spectacular/grandiose&장애의
불구의|disabled/infirme&기형의|deformed/difforme&재능이 있는|talented/doué&재정의
재무의|financial/financier&저속한
상스러운|vulgar/vulgaire&적격의
자격이 있는|eligible/éligible&적대하는|hostile/hostile&적은|small/petit&적자의|in deficit/déficitaire&전기의|electric/électrique&전례가 없는
전대미문의|unprecedented/sans précédent&전문적인|professional/professionnel&전부의
전체의|whole/entier&전염성의
전염병의|contagious/contagieux&전용의|reserved/réservé&전의
이전[일전]의|previous/précédent&예전의|former/ancien&사전의|prior/préalable&전적인|full/entier&전쟁의|martial/martial&전면적인
전반[전폭]적인|total/total&전투적인|militant/militant&전형적인|typical/typique&절대적인|absolute/absolu&절망한|desperate/désespéré&젊은
어린|young/jeune&정당한|just/juste&타당한|pertinent/pertinent&정면의|frontal/frontal&정부의|governmental/gouvernemental&정성을 들인|careful/soigneux&정신의학의|psychiatric/psychiatrique&정제된
세련된
섬세한|refined/raffiné&(매우)
정제된
세련된
섬세한|exquisite/exquis&근사한|chic/chic&정교한|sophisticated/sophistiqué&정직한|honest/honnête&정치의|political/politique&정해진
결정된|decided/décidé&확정된|determined/déterminé&정확한
정밀한|exact/exact&젖은
축축한|wet/trempé&제국의|imperial/impérial&제도적인|institutional/institutionnel&제약의
약학의|pharmaceutical/pharmaceutique&제한적인|restrictive/restrictif&조용한|quiet/tranquille&잔잔[고요]한|calm/calme&졸업한|graduated/diplômé&좁은
비좁은|narrow/étroit&협소한|cramped/exigu&종속적인|dependent/dépendant&종합적인
총합적인|synthetic/synthétique&좇같은
개같은|shitty/de merde&좋아하는|favourite/préféré&(무언가에 특히)
좋은|conducive/propice&좋은 집안 출신의
명문가의|from a good family/de bonne famille&주관적인|subjective/subjectif&주된|main/maître&주요한|principal/principal&주어진|given/donné&주위의
근처[부근]의|ambient/ambiant&주의가 산만한|distracted/distrait&죽은
돌아가신|died/mort&사망한
작고[별세]한|passed away/décédé&준비된
채비된|ready/prêt&중간의
중위의|medium/moyen&중개의
매개의|intermediate/intermédiaire&중고의|second-hand/d'occasion&(수준 따위가)
중급의|intermediate/intermédiaire&(품질 따위가)
중급의|of medium qualities/de qualité moyenne&중독된|addicted/accro&중성화된|neutered/stérile&중대한|serious/sérieux&즉석의
인스턴트의|instant/instantané&즐거운|joyful/joyeux&명랑[쾌활]한|cheerful/enjoué&증권의
주식의|stock market/boursier&증명된
입증된|proven/avéré&지겨운
싫증난
지루[심심]한|bored/ennuyé&지난|last/dernier&지나간|past/passé&지방의
현지의|local/local&지배적인|dominant/dominant&지속적인
지속 가능한|sustainable/durable&지역사회의|intercommunity/intercommunautaire&지친
힘든
피곤한|tired/fatigué&탈진한
기진맥진한|exhausted/exténué&녹초가 된|weary/épuisé&기운이 다 빠진
거의 쓰러지기 직전의|on one's last legs/à bout de force&지하의|underground/souterrain&직관적인|intuitive/intuitif&직업의
업무의|professional/professionnel&진|lost/perdu&패배한|defeated/défait&대패한
완파당한|vanquished/vaincu&진보의|progressive/progressif&진보한|advanced/avancé&선진의|developed/développé&진심의|sincere/sincère&진정한|true/véritable&진짜의|real/réel&진품[진본]의|authentic/authentique&진한
농후한|thick/épais&진행 중인|ongoing/en cours&질 좋은
퀄리티가 좋은|quality/de qualité&집단적인|collective/collectif&집착하는
집념하는|obsessed/obsédé&집착하지 않는
초연한|detached/détaché&집중적인
집약적인|intensive/intensif&짙은
빽빽[조밀]한|dense/dense&짧은|short/court&간략[짤막]한|brief/bref&착취당하기 쉬운
이용당하기 쉬운|exploitable/exploitable&착한|good/bon&친절한|kind/gentil&다정한|tender/tendre&정다운|affectionate/affectueux&상냥한|welcoming/accueillant&호의적인|sympathetic/sympathique&찬
차가운
추운
쌀쌀한|cold/froid&(얼음장 같이)
찬
차가운
추운
쌀쌀한|freezing/glacial&시원한
서늘한|cool/frais&참가한
참석[출석]한|present/présent&참을 수 없는|insupportable/insupportable&견딜 수 없는
버틸 수 없는|intolerable/intolérable&참을성 없는
성급한|impatient/impatient&참을성 있는|patient/patient&창백한
해쓱한|pale/pâle&창의적인
창조적인|creative/créatif&책임이 있는|responsible/responsable&처녀의
동정의|virgin/vierge&처음의|first/dernier&초기의|initial/initial&천연의|natural/naturel&철학의|philosophical/philosophique&청각의|acoustic/acoustique&청교도의|puritanical/puritain&청렴한|of integrity/intègre&청소년의|juvenile/juvénile&체계적인|systematic/systématique&초급의|beginner/débutant&총합의
총(總)|gross/but&최고급의
일류의|prestigious/prestigieux&(누군가가)
최고의
최상의|superb/superbe&(무언가가)
최고의
최상의|supreme/suprême&최근의|recent/recent&최신의|up-to-date/le plus moderne&최첨단의|state-of-the-art/ultramoderne&최적의|optimal/optimal&최종의
궁극의|ultimate/ultime&추론된
귀납된|induced/induit&추론된
연역된|deduced/déduit&추측되는
여겨지는
라고들 하는|supposed/censé&추한
추잡한|ugly/moche&충격적인|shoking/choquant&충동적인|impulsive/impulsif&충분한
넉넉한|enough/assez&취한
도취한|drunk/ivre&치사의
치명적인|lethal/létal&칩거하는
은둔하는
틀어 박힌|reclusive/reclus&거대한|colossal/colossal&막대한|enormous/énorme&부피[덩치]가 큰|bulky/volumineux&타고난
태생적인|innate/inné&선천적인
천성[천부]적인|natural/naturel&타락한|corrupt/corrompu&탄력적인|elastic/élastique&탈수한|dehydrated/déshydraté&탐욕스러운
욕심 많은|greedy/cupide&태양의|solar/solaire&태어난
출생한|born/né&터무니 없는|ridiculous/ridicule&불합리한
부조리한|absurd/absurde&퇴직한|retired/retraité&퇴폐적인|decadent/décadent&투박한
시골풍의|rustic/rustique&특별한|special/spécial&특수한|particular/particulier&특이한|singular/singulier&특정한|specific/spécifique&특단의|extraordinary/extraordinaire&독특한|unique/unique&각별한|distinguished/distingué&튼튼한|strong/fort&견고[공고]한|solid/solide&강건[건장]한|robust/robuste&내구성 있는|durable/durable&파란만장한|tumultuous/tumultueux&펴진
펼쳐진|spread out/étendu&편재하는
보편적으로 존재하는|omnipresent/omniprésent&편집증의
망상증의|paranoid/paranoïaque&(누군가가)
편한|at ease/à l'aise&(무언가가)
편한
편리한
편안[안락]한|comfortable/commode&평행한|parallel/parallèle&평화적인|peaceful/pacifique&평화적인
평화로운|peaceful/pacifique&풀린
풀어진|detached/détaché&포함된|included/compris&표현적인
표현력이 풍부한|expressive/expressif&푸짐한
수북한|ample/ample&풀 바디의|full-bodied/corsé&풀 수 없는
해결할 수 없는|inextricable/inextricable&풀 수 있는
해결할 수 있는|soluble/soluble&평온한|peaceful/paisible&(누군가가)
평범한
흔한|normal/normal&(무언가가)
평범한
흔한|ordinary/ordinaire&진부[시시]한|banal/banal&평평한
고른|even/plat&풀타임의|full-time/à temps plein&풍부한|rich/riche&풍요로운
풍성한|rich/riche&비옥한
기름진|fertile/fertile&피의
유혈의|bloody/sanglant&피부의|skin/cutané&필요한|required/requis&필수적인|necessary/nécessaire&요긴[긴요]한|imperative/impératif&하급의|inferior/inférieur&하는 일 없는
백수의|idle/oisif&하찮은|insignificant/insignifiant&형편없는|poor/nul&가소로운|derisory/dérisoire&빈약한
변변치 않는|meagre/maigre&보잘것없는|mediocre/médiocre&학교의|school/scolaire&학구적인|studious/studieux&학문의
학술의|scientific/scientifique&한가한
시간이 있는
여유가 있는|free/libre&항구의|port/portuaire&항암의|anticancer/anticancéreux&해로운
유해한|harmful/nuisible&해외로 이주한
이민간|expatriate/nuisible&(누군가가)
할 수 있는
가능한|capable/capable&(무언가가)
할 수 있는
가능한|possible/possible&합격한|accepted/admis&합의에 의한|by agreement/à l'amiable&항공의|air/aérien&핵의|nuclear/nucléaire&행성의|planetary/planétaire&헤어진
이별한|separated/séparé&허영심이 많은|vain/vaniteux&헌법의|constitutional/constitutionnel&헌신적인|devoted/dévoué&헛된
괜한|vain/vain&현대의|contemporary/contemporain&현실적인
실제적인|real/réel&현재의
현(現)
현행의|present/présent&현지인의|local/local&형식적인|formal/formel&혜택을 받는
수혜의|beneficiary/bénéficiaire&홀로인
혼자인|alone/seul&화석의|fossil/fossile&화폐의
통화의|monetary/monétaire&확신하는|sure/sûr&확실한
확연한|sure/sûr&활기를 주는|animating/animateur&활동적인
활발[발랄]한|active/actif&황량한
척박한|waste/ingrat&불모의|barren/stérile&회계의|accounting/comptable&획일적인|uniform/uniforme&효과적인
효율적인|efficient/efficace&후각의|olfactory/olfactif&후의
이후[사후]의|following/suivant&차후[추후]의|ulterior/ultérieur&후한
후덕한
관대한|generous/généreux&너그러운
이해심 있는|comprehensive/compréhensif&흐린
흐릿한
탁한
뿌연|gray/gris&불모의|barren/stérile&회계의|accounting/comptable&획일적인|uniform/uniforme&효과적인
효율적인|&현지인의|local/local&형식적인|formal/formel&혜택을 받는
수혜의|&쫓다
뒤쫓다
추적[추격]하다|chase/pourchasser&수업을 듣다|take the class/suivre le cours&(흔적을 따라)
쫓다
뒤쫓다
추적[추격]하다|track/traquer&미행하다
뒤를 밟다|tail/pister&쫓다
쫓아내다|chase away/chasser&몰아내다
배척하다|reject/rejeter&추방하다
유배[귀양]보내다|exil/exiler&퇴거[퇴장]시키다|expel/expulser&높이다|heighten/hausser&높아지다|heighten/hausser&낮아지다
저하되다|lower/baisser&낮추다
저하시키다|lower/faire baisser&쩔쩔매게 하다
애를 먹게 하다|stump/coincer&찌르다|plunge/plonger&(쿡) 찌르다|jab/piquer&촬영하다|shoot/tourner&찢다
파열시키다|tear/déchirer&차갑게 하다|chill/glacer&냉장하다|refrigerate/réfrigérer&냉각하다|cool/refroidir&차별하다|discriminate/faire de la discrimination&차별화하다|differentiate/différencier&차지하다
점하다|occupy/occuper&(비율을)
차지하다
점하다|represent/représenter&점령하다|occupy/occuper&잠식하다|encroach on/empiéter sur&장악하다
수중에 넣다|seize/s'emparer de&점유[점거]하다|occupy/occuper&제 것으로 삼다|take for oneself/s'approprier&착륙하다|land/atterrir&착취하다|exploit/exploiter&찬성하다
동의하다|agree/accorder&승낙하다|consent to/consentir à&찬동[동조]하다|approve of/approuver&찬양하다
찬송하다|praise/louer&칭송하다|glorify/glorifier&참가하다
참여하다|participate in/participer à&(시험, 경기 따위에)
참가하다
참여하다|play/disputer&(토론, 소송 따위에)
참가하다
참여하다|intervene in/intervenir à&참석[출석]하다|attend/assister à&참고하다|consult/consulter&감내[감당]하다|hold back/retenir&견디다
버티다|tolerate/tolérer&인내하다|persevere/persévérer&참다|stand/supporter&참조하게 하다|refer/renvoyer&창백해지다
해쓱해지다|go pale/pâlir&찾다
찾아내다|find/trouver&발견하다|discover/découvrir&검색하다|search/rechercher&찾아다니다|be looking for/être à la recherche de&검출[탐지]하다|detect/détecter&채우다|fill/remplir&보충[보완]하다|complete/compléter&채점하다
점수를 매기다|mark/noter&채취하다
따다|pick/cueillir&처리하다|deal with/s'occuper de&(데이터 따위를)
처리하다|process/traiter&(신속하게) 처리하다|expedite/expédier&(쓸모없는 무언가 또는 누군가를)
처리하다
처분하다|get rid of/se débarrasser de&처방하다|prescribe/prescrire&처벌하다
제재하다|punish/sanctionner&벌칙을 주다
불이익을 주다|penalise/pénaliser&처형하다|execute/exécuter&척 하다
체 하다|pretend/faire semblant&천둥치다|thunder/tonner&청구하다|claim/réclamer&청소하다
깨끗이 하다|clean/nettoyer&(쓸거나 비질하여)
청소하다
깨끗이 하다|sweep/balayer&체면을 지키다|keep up appearances/sauver les apparences&초대하다
초청하다|invite/inviter&초월하다|transcend/transcender&초점을 맞추다
포커스를 맞추다|focus on/focaliser sur&촉진하다
진흥하다|promote/promouvoir&가속하다
속도를 올리다|accelerate/accélérer&조장[장려]하다|encourage/encourager&조성[육성]하다|foster/favoriser&총괄하다
통괄하다|coordinate/coordonner&최고조에 달하다
절정[정점]에 달하다|peak/culminer&최고에 오르다
최고를 달리다|be in the lead/arriver en tête&최선을 다하다|do one's best/faire de son mieux&추론하다
추리하다|reason/raisonner&(귀납적으로)
추론하다
추리하다|induce/induire&(연역적으로)
추론하다
추리하다|deduce/déduire&추모하다|commemorate/commémorer&추이를 지켜보다|wait and see/suivre&(로켓 따위를) 추진하다|propel/propulser&(사업 따위를)
추진하다
밀고 나가다|push ahead with/impulser&추측하다|suppose/supposer&추정하다|presume/présumer&짐작하다|guess/deviner&축복하다|bless/bénir&축하하다|congratulate/féliciter&출세하다|make a fortune/faire fortune&출시하다|launch/lancer&출신이다|be from/venir de&후손이다|be descended from/descendre de&출연하다|appear/apparaître&출장가다|go on a business trip/aller en voyage d'affaires&충격을 주다|shock/choquer&타격을 주다|hit/frapper&트라우마를 일으키다
정신적인 외상을 입히다|traumatise/traumatiser&충분하다
족하다
만 하면 된다
만으로도 하다|be enough/suffire&충전하다|charge/charger&취소하다|cancel/annuler&돌이키다
철회하다|withdraw/retirer&해제하다|lift/lever&해지하다|close/résilier&취업하다|get hired/se faire embaucher&취하게 하다
도취시키다|make drunk/enivrer&(자동차 따위가)
치다|hit/renverser&(시험을)
치다
보다
치르다|take/passer&(물건을) 치우다|remove/enlever&(물건 또는 장소를) 치우다|clear/débarrasser&침략하다
침공하다|invade/envahir&침묵시키다|reduce to silence/réduire au silence&침을 뱉다|spit/cracher&침을 튀기다|splutter/postillonner&침을 흘리다|dribble/baver&침투하다
침입[잠입]하다|penetrate/pénétrer&칭찬하다|compliment/complimenter&치하하다|praise/louer&캐다|dig/arracher&컨닝하다|cheat/tricher&켜다|turn on/allumer&클로즈업하다|zoom in/zoomer sur&복학하다|resume one's studies/reprendre ses études&큰 마음을 먹다|take the plunge/se jeter à l'eau&(평소에는 누리지 못하는
무언가를 자신에게 사주어)
큰 마음을 먹다|treat oneself to/se faire plaisir en s'offrant&마음을 단단히 먹다
마음을 독하게 먹다|steel oneself/s'armer de courage&키스하다
입맞추다|kiss/embrasser&(차 따위에) 타다|take/monter&탑승하다
승차[승선]하다|board/embarquer&(상 따위를) 타다|win/remporter&타다
불타다|burn/brûler&탄핵하다|impeach/destituer&탈선시키다
나쁜 길로 이끌다|lead astray/dévoyer&탈수시키다|dehydrate/déshydrater&탐내다|be eager for/avoir soif de&갈망하다|long for/convoiter&탐험하다
탐색[탐사]하다|explore/explorer&태어나다
출생하다|be born/naître&태우다
불태우다|burn/brûler&소각하다|incinerate/incinérer&타오르게 하다|inflame/enflammer&태우다
태워주다|give a ride/conduire&터뜨리다|burst/éclater&(감정 따위를) 터뜨리다|vent/déchaîner&터무니없는 계획을 하다
사상누각을 짓다|be pie in the sky/tirer des plans sur la comète&터지다|burst/éclater&폭발하다|explode/exploser&털다|burgle/dévaliser&약탈하다
노략질하다|plunder/piller&털어놓다
토로하다|confide/confier&실토[토설]하다|confess/confesser&(사람의)
털을 깎다
면도해주다|shave/raser&(동물의)
털을 깎다
면도해주다|shear/tondre&통곡하다
탄식[한탄]하다
애통[통탄]하다|lament/se lamenter&통하다
소통하다|communicate/communiquer&(교통, 전기, 전화 따위가)
통하다|serve/desservir&(길, 하천 따위가)
통하다|come out on/déboucher sur&(집의 방향이)
향하다
향해 나있다|overlook/donner sur&퇴사하다|resign/résigner&퇴직하다
은퇴하다|retire/se retirer&투기하다|speculate on/spéculer sur&투옥하다|imprison/emprisonner&수감하다|incarcerate/incarcérer&감옥에 넣다
철창 속에 가두다|put under lock and key/mettre sous les verrous&투자하다|vinvest/investir&투표하다|vote/voter&튀기다
프라이하다|fry/frire&(불쑥) 튀어나오다|appear suddenly/surgir&튀어나오다
돌출하다|stick out/saillir&(위로)
튀어나오다
돌출하다|overhang/surplomber&튀어오르다|bounce/rebondir&틀리다|be wrong/avoir tort&틀어 박히다
칩거[은둔]하다|shut oneself up/se calfeutrer&파다
파고들다|dig/fouiller&(깊이)
파다
파고들다|deepen/approfondir&발굴하다|excavate/exhumer&파면하다|expel/expulser&파산시키다|ruin/ruiner&파업하다|strike/faire grève&판결하다|judge/juger&판단하다|judge/juger&판별하다
식별[감별]하다|discriminate/discriminer&팔다
매도하다
판매[매각]하다|sell/vendre&(자신을 홍보하여 자신
또는 자신의 노동력 따위를)
팔다|sell oneself/se vendre&(팔아서) 처분하다|dispose/disposer de&패에 걸다
전술로 삼다
방책을 택하다|play the card/jouer la carte&퍼뜨리다
번지게 하다|spread/répandre&확산시키다|diffuse/diffuser&분산시키다|disperse/disperser&선전[전파]하다|propagate/propager&퍼지다
번지다|spread/se répandre&창궐하다|infest/infester&펴다
펼치다|spread/étendre&(접힌 것을)
펴다
펼치다|unfold/déplier&(말린 것을)
펴다
펼치다|unroll/dérouler&(특히 신체 따위를)
펴다
펼치다|stretch/redresser&전개[산개]하다|develop/développer&편들다
두둔하다
역성을 들다|side with/prendre parti pour&편집하다|edit/monter&편히 있다
편히 지내다|make oneself at home/faire comme chez soi&평하다
평가하다|estimate/estimer&감정하다|evaluate/évaluer&폐하다
폐지하다
철폐[폐기]하다|abolish/abolir&폐하다
폐위하다
퇴위시키다|dethrone/détrôner&포기하다|give up/renoncer à&포함하다
포괄하다|include/comprendre&아우르다
망라하다|cover/recouvrir&함유하다
들어있다|contain/contenir&내포하다|implicate/impliquer&폭격하다
포격하다|bomb/bombarder&표리부동하다
겉 다르고 속 다르다|play a double game/jouer double jeu&표방하다|advocate/afficher&표시하다
마킹을 하다|mark/marquer&체크를 하다|check/cocher&표절하다|plagiarise/plagier&표준화하다
규격화하다|standardise/standardiser&표하다
표명하다|declare/déclarer&표하다
표시하다|show/témoigner&표하다
표현하다|express/exprimer&풀다
해결하다|settle/régler&(어려운 문제를)
풀다
해결하다|untie/débrouiller&(감정 따위를)
풀다
해소하다|dispel/dissiper&(옷 따위를) 풀다|undo/défaire&(얽힌 것을) 풀다|untangle/démêler&(포장 따위를) 풀다|unwrap/déballer&(긴장된 분위기 따위를) 풀다|thaw/dégeler&(알을) 품다|brood on/couver&풍요롭게 하다
풍부[풍성]하게 하다|enrich/enrichir&비옥하게 하다
기름지게 하다|fertilise/fertiliser&풍요롭다
풍부[풍성]하다|abound/abonder&피다
피어나다
개화하다|bloom/fleurir&피폐하게 하다|impoverish/appauvrir&피하다|avoid/éviter&회피[기피]하다|evade/esquiver&모면하다|escape/échapper à&필요하다
요하다|need/avoir besoin de&필적하다
비길 만하다
견줄 만하다|rival/rivaliser avec&하고 싶게 하다|give the desire to/donner l'envie de&하곤 한다
하는 습관이 있다|have a habit of/avoir l'habitude de&하는 관습이 있다|be customary to/être coutumier de&하기가 어렵다
못하다
부족하다|have difficulty/avoir du mal à&하는 경향이 있다
잘하다
하기 쉽다|tend to/avoir tendance à&하는 기분이다|have a feeling of/avoir l'impression de&하는 중이다|be in the middle of/être en train de&하는 편이 낫다|had better/faire mieux de&행하다|conduct/effectuer&하지 않을 수 없다|can't help/ne pas pouvoir s'empêcher de&하품하다|yawn/bâiller&학살하다
살육하다|massacre/massacrer&말살하다
절멸[멸종]시키다|exterminate/exterminer&한 마음이다
의견을 같이하다|agree together/être en accord ensemble&한몫하다
역할을 하다|play a part/jouer un rôle&할 만하다|be worthy of/être à&할 가망이 있다
할 가능성이 있다|have a chance/avoir une chance&할당하다
충당하다|assign/assigner&할인하다
깎다|give a discount/faire une remise&핥다|lick/lécher&함구하다
말하지 않다
잠자코 있다
입을 다물다
조용히 하다|keep quiet/taire&함축하다
함의하다|implicate/impliquer&합격하다|pass/réussir&합법화하다
양성화하다|legalise/légaliser&합의하다|agree on/s'entendre sur&끼다
합류하다|join/rejoindre&합치다|join/joindre&통합하다|integrate/intégrer&융합하다|fuse/fusionner&결합하다|unite/unir&조합하다|combine/combiner&병합[합병]하다|merge/fusionner&(영토 따위를) 병합[합병]하다|annex/annexer&편입하다|incorporate/incorporer&합성하다|synthesise/synthétiser&통일하다
단일화하다|unify/unifier&종합[총합]하다|synthesise/synthétiser&합치되다
의견을 같이하다|agree with/s'accorder à&항복하다|surrender/se rendre&항의하다|protest against/protester contre&이의를 제기하다|contest/contester&해고하다|dismiss/licencier&해고하다
자르다|fire/virer&해당하다
대응되다
상응[상당]하다|correspond to/correspondre à&해방하다|liberate/libérer&할 만하다
해볼 만하다|be worth a try/valoir la peine&해석하다|interpret/interpréter&해독하다|decrypt/décrypter&의무가 있다|be obliged to/être obligé de&해체하다
분해하다|take apart/démonter&해체하다
해산하다|disperse/disperser&해치다
해를 입히다|harm/nuire à&침해[침범]하다|violate/violer&가해[폭행]하다|assault/agresser&손해[피해]를 입히다|damage/endommager&햇빛을 보다
세상에 나오다|see the light of day/voir le jour&행동하다|act/agir&굴다|act/agir&처신하다|conduct oneself/se conduire&해드리다
기꺼이 하다|would be happy to/se faire un plaisir de&행세를 하다|pretend to be/se faire passer pour&허락하다
허가[용납]하다|allow/admettre&허용[용인]하다|tolerate/tolérer&가능하게 하다
할 수 있게 하다|permit/permettre&좋다고 하다
괜찮다고 하다|authorise/autoriser&허물을 벗다
새로이 거듭나다|change its skin/changer de peau&허세를 떨다
엄포를 놓다|bluff/frimer&허약하게 하다
약골로 만들다|weaken/fragiliser&헛된 생각을 하다
엉뚱한 생각을 하다|have one's head in the clouds/se faire des idées&헛소리를 하다|talk nonsense/délirer&횡설수설하다|babble/déraisonner&찾다
찾으려 하다|look for/chercher&헤어지다
이별하다|separate/se séparer&헤쳐나가다
기사회생하다
궁지[난관]에서 벗어나다|get through it/s'en sortir&현실적이다
현실주의자이다|have one's feet on the ground/avoir les pieds sur terre&협력하다
협조[협동]하다|cooperate on/coopérer à&협상하다
교섭하다|negociate/négocier&호화롭게 살다
호의호식하다|live in clover/mener grand train&혼내다
꾸짖다
꾸지람하다|scold/gronder&나무라다
책망하다|blame/blâmer&질책하다
야단치다|reproach/reprocher&질책[문책]하다|reprimand/réprimander&혼동하다
헷갈리다|confuse/confondre&혼잣말을 하다|talk to oneself/se parler à soi-même&홍보하다
판촉하다|promote/promouvoir&화나게 하다|anger/fâcher&신경질나게 하다
짜증나게 하다|annoy/énerver&성나게 하다
열받게 하다|irritate/irriter&격노[격분]하게 하다
분노[분개]하게 하다|enrage/exaspérer&언짢게 하다|offend/vexer&빡치게 하다|piss off/faire chier&화내다|get angry/se mettre en colère&킹받다
꼴받다|be pissed off/avoir le seum&화장하다|put on make-up/se maquiller&화합시키다
조화시키다|harmonise/harmoniser&확실하게 하다|ensure/assurer&확인되다|prove to be/s'avérer&확인하다|verify/vérifier&환각을 일으키다|hallucinate/halluciner&환멸을 느끼게 하다|disillusion/désillusionner&환불하다
환불해주다|refund/rembourser&환영하다
환대하다|welcome/accueillir bien&환호하다|cheer/acclamer&활기를 잃다
침체되다
부진하다|stagnate/stagner&활기를 주다|animate/animer&활성화하다|activate/activer&(경제 따위를)
활성화하다|boost/doper&활동하다|work/travailler&(열성적으로)
활동하다
운동하다|campaign for/militer&회개하다
뉘우치다|repent of/se repentir de&(병 따위에서) 회복되다|recover/se remettre&회복하다|recover/rétablir&꾸미다
꾀하다
획책하다|plot/mijoter&횡령하다
유용[착복]하다|embezzle/détourner&남의 돈을 떼먹다|line one's own pocket/manger la grenouille&후회하다|regret/regretter&훈계하다|lecture/faire la morale&훈련시키다
연습시키다|train/entraîner&훔치다|steal/voler&훤하다
통달하다
능통[정통]하다|have thorough knowledge of/s'y connaître en&깊이 알다
조예가 깊다|have profound knowledge of/en savoir long sur&휘두르다|brandish/brandir&젓다
휘젓다
버무리다
뒤적거리다|stir/remuer&휘파람을 불다|whistle/siffler&흐르다
흘러 지나가다|flow/couler&흐리게 하다
흐려지게 하다
탁하게 하다
뿌옇게 하다|cloud/troubler&흐리다
흐려지다|get cloudy/se couvrir&흔들다|shake/secouer&(규칙적으로) 흔들다|swing/balancer&떨다
떨리다|tremble/trembler&뒤흔들다|rock/ébranler&흔들리다|shake/se secouer&진동하다|vibrate/vibrer&요동치다|fluctuate/fluctuer&흘러나오다|come out of/découler de&흘러들다
유입되다|flow/affluer&흡수하다|absorb/absorber&흩뜨리다
흐트러뜨리다
흩어지게 하다|scatter/éparpiller&흥미가 있다
관심이 있다|be interested in/s'intéresser à&흥미롭게 하다
관심을 끌다|interest/intéresser&호기심을 끌다|intrigue/intriguer&획일화하다|standardise/uniformiser&희미하게 하다|tone down/estomper&희미해지다|fade/pâlir&희생하다|sacrifice/sacrifier&힘을 빌다
방책으로 삼다|resort to/recourir à&예측하다|prognosticate/pronostiquer&하기로 하다|be supposed to/être censé&처하다
처해 있다|deal with/rencontrer&해도 된다|have the right to/avoir le droit de&할 뻔하다
할락 말락 하다|be about to/manquer inf.&배가하다, 더욱 하다|redouble/redoubler&배고프게 하다|make hungry/donner faim à&선언하다|declare/déclarer&(판결 따위를)
선고하다
언도하다|pronounce/prononcer&(형을)
선고하다
언도하다|sentence/condamner&가까워지다, 다가가다|approach/approcher&증진[진전]시키다|improve/améliorer&교대로 하다
번갈아 하다|take turns/se relayer&접근[근접]하다|access/accéder&가난하게 하다, 빈곤하게 하다|impoverish/appauvrir&향하다|head/se diriger&전진하다|advance/avancer&가버리다|go away/s'en aller&나아가다|advance/avancer&(시간이) 가다|pass/passer&가두다|shut up/enfermer&감금하다|confine/confiner&구금하다|detain/détenir&유폐하다|immure/emmurer&가라앉다, 침몰하다|sink/sombrer&가라앉다, 침전하다|precipitate/se précipiter&가렵다
간질간질하다, 근질근질하다|itch/démanger&가르치다|teach/apprendre&교육하다|educate/enseigner&가볍게 하다, 경감[감경]하다|lighten/alléger&가입하다|join/rejoindre&가정하다|suppose/supposer&가져가다, 가지고가다|take/emporter&도로 가져가다, 가지고 돌아가다|take back/remporter&가져오다, 가지고오다|bring/apporter&도로 가져오다, 가지고 돌아오다|bring back/rapporter&소지하다|hold/détenir&소유[보유]하다|possess/posséder&가하다, 입히다|inflict/infliger&각색하다|dramatise/dramatiser&각출하다
회비를 내다, 분담금을 내다|contribute/cotiser&간지럽히다|tickle/chatouiller&간척하다|reclaim/assécher&갈다, 뾰족하게 하다|point/pointer&갈다, 날카롭게 하다|sharpen/aiguiser&감독하다|oversee/superviser&(영화를) 감독하다|direct/réaliser&감동시키다|move/émouvoir&감사하다|thank/remercier&고마워하다|appreciate/apprécier&감상하다|appreciate/apprécier&음미하다|degust/déguster&감전시키다|electrocute/électrocuter&감염시키다, 전염시키다|infect/infecter&감히 하다|dare/oser&강간하다
욕보이다, 능욕[겁탈]하다|rape/violer&강등시키다|degrade/dégrader&강요하다, 강제하다
억지로 하게 하다|force/forcer&할 수 밖에 없게 하다|oblige/obliger&마지못해 하게 하다
어쩔 수 없이 하게 하다|compel/contraindre&처하게 하다
치르도록 하다|put/soumettre&몰아넣다
몰아붙이다|drive/acculer&강조하다|emphasise/marquer&부각하다|accent/accentuer&역설하다
역점을 두다|underline/souligner&강타하다
초토화하다, 황폐화하다|devastate/dévaster&강하게 하다
강화하다, 보강[증강]하다|reinforce/renforcer&(제자리에) 갖다 놓다|put back/remettre&갖추게 하다
갖추어주다|fit out/munir&(가구를) 장착[설비]시키다
구비[비치]시키다|furnish/meubler&(장비를) 장착[설비]시키다
구비[비치]시키다|equip/équiper&갚다
상환하다|repay/rembourser&(광산, 자원 따위를)
개발하다, 개척[개간]하다|exploit/exploiter&개선하다, 개량하다|improve/améliorer&개종시키다|convert/convertir&거래하다|trade/faire affaire&거르다
여과하다|filter/filtrer&거스르다
거역하다|disobey/désobéir&거슬러 올라가다|date back/remonter&거세하다
중성화하다|neuter/stériliser&거절하다, 거부하다|refuse/refuser&사양하다|decline/décliner&거친 소리를 내다|crack/craquer&거닐다|stroll/flâner&걷어올리다
말아올리다|roll up/relever&(돈 따위를) 걸다|bet/parier&(목숨 따위를) 걸다|risk/risquer&걸다
매달다|hang/accrocher&(시간 따위가) 걸리다|take/prendre&오래 걸리다, 오래 끌다|drag on/traîner&(병 따위에) 걸리다|catch/attraper&걸치다
기대어 놓다|lean/appuyer&검문하다|stop and question/interpeller&검사하다|examine/examiner&점검하다|inspect/inspecter&검열하다|censor/censurer&검토하다|review/revoir&것이다
속하다, 소속하다|belong to/appartenir à&일부[일원]이다|be part of/faire partie de&겨루다|contend for/rivaliser de&경쟁하다|compete/être en compétition&게시하다|post/afficher&게재하다|publish/publier&겨누다
목표로 하다
조준[겨냥]하다|aim/viser&대상으로 지정하다
타겟팅하다|target/cibler&격화시키다
격렬해지게 하다|intensify/intensifier&겪다
받다
입다
당하다
치르다|go through/connaître&경험[체험]하다|experience/expérimenter&(의사에 반하는 부정적인 것 또는
어떠한 작용이나 영향 따위를)
받다
입다
당하다
치르다|undergo/subir&(특히 피해, 비난, 패배 따위를)
받다
입다
당하다
치르다|suffer/essuyer&결심하다
다짐하다|decide/décider&결투를 하다|duel/se battre en duel&결혼하다
혼인하다|marry/se marier&경고하다
주의를 주다|warn/donner un avertissement&(구획을 위해)
경계를 세우다
말뚝을 세우다|stake off/jalonner&뻣뻣해지다
경직되다|stiffen/raidir&경호하다
호위[수행]하다|escort/escorter&경화시키다
굳게 하다
단단[딱딱]하게 하다|harden/durcir&계산하다
추산하다
산정[산출]하다|calculate/calculer&계약하다|contract/contracter&계획하다, 설계하다|plan/projeter&기획하다|organise/organiser&고려하다|consider/considérer&고찰하다|consider/considérer&심사숙고하다
곰곰이 생각하다|reflect/réfléchir&고르다
택하다
선택하다|choose/choisir&채택하다|adopt/adopter&추려내다
선별하다|select/trier&차출하다
선발[선정]하다|select/sélectionner&고립시키다, 격리시키다|isolate/isoler&(전염병을 막기 위해) 고립시키다, 격리시키다|quarantine/mettre en quarantaine&고문하다|torture/torturer&고발하다|accuse/accuser&고백하다|declare/déclarer&고생하다
애쓰다
애먹다|struggle/peiner&고소하다|sue/poursuivre&고용하다|hire/embaucher&채용하다|recruit/recruter&고장나다|break down/tomber en panne&고장내다|break/mettre en panne&고정시키다|fix/fixer&꼼짝 못하게 하다
움직이지 못하게 하다|immobilise/immobiliser&고체화하다
응고[응결]하다|solidify/solidifier&고치다
치료[치유]하다|heal/guérir&곱하다
곱셈을 하다|multiply/multiplier&공개하다
공표하다|make public/rendre public&공격하다|attack/attaquer&공기를 빼다|deflate/dégonfler&공포하다
반포하다|promulgate/promulguer&과격하게 하다
급진적이게 하다|radicalise/radicaliser&과대평가하다
고평가하다|overestimate/surestimer&과세하다
세금을 부과하다|tax/imposer&과소평가하다
저평가하다|underestimate/sous-estimer&과장하다
비약하다|exaggerate/exagérer&연관되다, 상관있다|concern/concerner&관련[관계]되다|have relation to/se rapporter à&관한 것이다|be about/s'agir de&관리하다|manage/gérer&제어하다|control/contrôler&지도하다|direct/diriger&괜찮다|suit/aller&괴롭다
고통스럽다|suffer/souffrir&괴롭히다
고통스럽게 하다|make suffer/faire souffrir&(특히 조직 내에서)
괴롭히다
고통스럽게 하다|harass/harceler&교환하다
맞바꾸다
주고받다|exchange/échanger&구걸하다|beg/faire la manche&구기다|crease/froisser&구독하다|subscribe to/s'abonner à&구별되다
구분[분간]되다|stand out/se démarquer&구별하다
구분[분간]하다|distinguish/distinguer&분별[변별]하다|discern/discerner&판별하다|discriminate/discriminer&구부리다
휘게 하다|bend/courber&구사하다
자유자재로 하다|have a command of/maîtriser&구체화하다|shape/concrétiser&구하다, 구조[구출]하다|save/sauver&구원[구명]하다|rescue/secourir&규제를 풀다|deregulate/déréguler&국유화하다|nationalise/nationaliser&굶주리다|starve/s'affamer&단식[금식]하다|fast/jeûner&굽다|roast/rôtir&굽히지 않다
우기다
고집하다
고수[일관]하다|persist/persister&궁금하다|wonder/se demander&궁지에 몰아넣다|corner up/acculer&권하다
조언하다
하는 것이 좋다|advise/conseiller&권유하다|invite/inviter&추천하다
권장[권고]하다|recommend/recommander&권한을 주다
자격을 주다|authorise/habiliter&규정하다|prescribe/qualifier&그리다, 데생하다|draw/dessiner&그리다, 채색하다|paint/peindre&그립다|miss/manquer&극대화하다|maximise/maximiser&극복하다
이겨내다|overcome/franchir&(선 따위를) 긋다|trace/tracer&긁다|scratch/gratter&할퀴다|scratch/griffer&금하다
금지하다
안된다
못하게 하다
할 수 없게 하다|forbid/interdire&기권하다|abstain/s'abstenir&(감탄을 보이어) 기념하다|celebrate/célébrer&(사람 또는 사건을 기리어) 기념하다|commemorate/commémorer&기다리다
대기하다|wait/attendre&기대다|lean on/s'appuyer sur&기도하다|pray/prier&기르다
키우다|raise/élever&양육하다|nurture/nourrir&사육하다|raise/élever&재배하다|cultivate/cultiver&기리다|honor/honorer&기분이 좋다|feel good/se sentir bien&기쁘다|have the pleasure/avoir le plaisir&들뜨다
기뻐서 어쩔 줄 모르다|be beside oneself with joy/être aux anges&기쁘게 하다|delight/faire plaisir&기습하다
급습[습격]하다|surprise/surprendre&허를 찌르다
불시에 덮치다|catch off guard/prendre de court&기억하다
상기하다|remember/se souvenir de&기여하다
공헌하다|contribute to/contribuer à&기울다
기울어지다|incline/incliner&기죽이다
좌절[낙담]시키다
용기[의욕]을 꺾다|discourage/décourager&의기소침하게 하다
우울하게 하다|depress/déprimer&주눅들게 하다
위축시키다|intimidate/intimider&사기를 꺾다|demoralise/démoraliser&기초하다, 기반하다
기저로 하다|be based on/se baser sur&근거[의거]하다|rest on/reposer sur&기화시키다, 증발시키다|vaporise/vaporiser&기화시키다, 가스화하다|gasify/gazéifier&긴장시키다
경색시키다|tense/tendre&긴장을 풀다|relax/relaxer&길들이다|tame/apprivoiser&(요 따위를) 깔다|lay/mettre&깨다
깨뜨리다|break/casser&박살내다
격파하다|smash/écraser&타파하다|destroy/détruire&(계약 따위를) 파기하다|break/casser&(특히 상고심에서 하급심 판결을)
파기하다|quash/casser&깨우다|wake/réveiller&일깨우다|awaken/éveiller&꺼내다|pull/tirer&꺾다
무찌르다
물리치다|beat/battre&꾸미다|beautify/embellir&장식하다|decorate/décorer&꿈꾸다|dream/rêver&꿈틀거리다
꼼지락거리다|wriggle/gigoter&(불을) 끄다|put up/éteindre&(조명 또는 기기를) 끄다|turn off/éteindre&(줄 따위가)
끊기다
끊어지다|cut/se couper&끊다
절단하다|cut/couper&끊다
단절하다|sever/rompre&(전화를) 끊다|hang up/couper&(기호품 따위를) 끊다|stop/arrêter&(실체를)
끌다
끌어들이다
끌어모으다|draw/tirer&(실체 또는 관념을)
끌다
끌어들이다
끌어모으다|attract/attirer&끝장내다|get over with/en finir avec&끝내 하다
마침내 하다|end up/finir par&마무리하다
결론을 내리다|conclude/conclure&종료[종결]하다|terminate/terminer&마침표를 찍다
종지부를 찍다|put an end/mettre un point final&끼니를 거르다|skip meals/sauter les repas&끼어들다
참견하다|meddle in/se mêler de&간섭하다|interfere in/s'ingérer dans&개입[관여]하다|get involved in/intervenir à&꿰매다
바느질하다|sew/coudre&(누군가가)
나가다
나오다|leave/quitter&(누군가 또는 무언가가)
나가다
나오다|go out/sortir&나누다|divide/diviser&분리하다|separate/séparer&분할하다|divide/diviser&(여러 개로) 분할하다|dismember/démembrer&분류하다|sort/trier&분절하다|segment/segmenter&세분하다|subdivide/subdiviser&나누어주다|hand out/répartir&분배[배분]하다
배부[배포]하다|distribute/distribuer&보급[배급]하다|distribute/distribuer&(식량 따위를) 배급하다|ration/rationner&나뉘다
나누어지다
갈라지다
분기하다|diverge/diverger&나다
돋다
트다|bud/naître&발아하다|germinate/germer&나타나다
생기다|appear/paraître&출현[등장]하다|appear/apparaître&(무언가가) 나타내다|indicate/indiquer&(누군가 또는 무언가가) 나타내다|represent/représenter&낙오하다
뒤처지다|fall behind/traîner&낙태시키다|abort/avorter&낚다
낚시하다|fish/pêcher&난파하다|wreck/faire naufrage&날다
비행하다|fly/voler&날아오르다
비상하다|soar/s'envoler&날인하다
도장을 찍다|seal/sceller&남기다
남겨놓다
남겨두다|leave/laisser&남다
남아있다
잔존하다|remain/rester&남용하다
오용하다|abuse/abuser de&납치하다
유괴하다|kidnap/enlever&낭비하다
허비하다|waste/gaspiller&낳다
출산[분만]하다|bear/engendrer&(알을) 낳다|lay/pondre&내다
제출하다|submit/soumettre&(영화, 음반 따위를)
내다
발매하다|release/sortir&(책 따위를)
내다
출판하다
발행[간행]하다|publish/publier&내다
지불[결제]하다
납부[불입]하다|pay/payer&떨어뜨리다
하락시키다|lower/faire baisser&떨어지다
하락하다|lower/baisser&내리다|lower/faire baisser&인하하다|reduce/rabaisser&격하시키다|downgrade/dégrader&내리다
하차하다|get off/descendre&내리다
하역하다|unload/décharger&(비, 눈 따위가) 내리다|fall/tomber&내밀다
내뻗다|project/projeter&냄새가 나다|smell/sentir&격앙시키다|exacerbate/exacerber&너무하다
과하다
정도가 지나치다|go too far/aller trop loin&고조시키다|heighten/faire monter&내려가다
내려오다
하강하다|descend/descendre&넓히다|widen/agrandir&확장하다|enlarge/élargir&(페이지를) 넘기다|turn/tourner&(기한 따위를) 넘기다|pass/dépasser&넘기다
넘겨주다|hand over/remettre&건네다
건네주다|pass/passer&물려주다|transmit/transmettre&양보하다|yield/concéder&양도하다|transfer/transférer&할양하다|cede/céder&이전[이양]하다|transfer/transférer&(상품 따위를) 인도[인계]하다|deliver/livrer&(국제법에 의해 범인을) 인도[인계]하다|extradite/extrader&(실체를) 넘다, 넘어가다|go over/passer&(관념을) 넘다, 넘어가다|pass/passer&넘어서다
뛰어넘다|surpass/surpasser&초과[상회]하다|exceed/excéder&넘어가다|pass/passer&넘어뜨리다|let fall/faire tomber&넘어지다|fall/tomber&넘치다
범람하다
넘쳐나다
넘쳐흐르다|overflow/déborder&넣다
집어넣다|put/mettre&밀어넣다|push/pousser&쑤셔넣다|cram/fourrer&삽입하다|insert/insérer&투입하다|put/mettre&주입하다|inject/injecter&입력하다|input/saisir&노래하다|sing/chanter&흥얼거리다
콧노래를 부르다|hum/chantonner&노력하다|make effort/faire des efforts&애쓰다
하려 하다|try to/chercher à&힘쓰다
진력하다
열심히 하다|strive to/travailler à&녹다|melt/fondre&녹음하다|record/enregistrer&녹이다|melt/fondre&용해하다|dissolve/dissoudre&놀다|play/jouer&놀라게 하다|surprise/étonner&감탄하게 하다|enthral/émerveiller&경악시키다|stupefy/stupéfier&놀라다, 감탄하다|admire/admirer&기가 막히다|can't get over it/ne pas en revenir&놀라서 펄쩍 뛰다|jump out of one's skin/avoir un sursaut&농담하다
농을 하다|joke/blaguer&말장난을 하다
우스갯소리를 하다|pun/plaisanter&농축하다|enrich/enrichir&압축하다|compress/compresser&응축하다|condense/condenser&놓고 가다
놓고 오다|leave/laisser&(어떤 상태로)
놓다, 두다|leave/laisser&놓다, 두다|put/mettre&내려놓다|lay down/déposer&배치하다|dispose/disposer&위치시키다|place/placer&놓다
놓아주다
풀다
풀어주다|release/libérer&석방[방면]하다|release/libérer&방출[방사]하다|release/libérer&놔두다
놓아두다
내비두다
내버려두다|leave/laisser&(기회 따위를) 놓치다|miss/manquer&방임하다|leave to oneself/laisser faire&방치하다|neglect/négliger&제쳐두다
차치하다|set aside/laisser de côté&누르다|press/presser&누리다
만끽하다|enjoy/profiter bien de&누비다
누비고 다니다|travel/sillonner&눈에 띄다|stand out/se remarquer&눈치를 보다|read one's face/ménager&눕다|lie down/s'allonger&(감각 따위를) 느끼다|feel/sentir&(감정 따위를) 느끼다|feel/se sentir&느슨하게 하다|loosen/lâcher&늘이다|stretch/étirer&연장하다|extend/prolonger&늘리다
키우다|extend/agrandir&(실력 따위를)
늘리다
키우다|improve/améliorer&증가[증대]시키다|increase/augmenter&(크게) 증가[증대]시키다|multiply/multiplier&늘어놓다|spread/déployer&(어수선하게) 늘어놓다|scatter/disperser&진열하다|display/exposer&(아래로)
늘어지다
처지다|hang down/pendre&늙다|grow older/vieillir&노화하다|age/vieillir&늦잠을 자다|oversleep/se réveiller en retard&늦추다
지연[지체]시키다|delay/retarder&유보[보류]하다|reserve/réserver&유예하다|suspend/suspendre&연기하다|postpone/renvoyer&(특히 회의 따위를) 연기하다|adjourn/ajourner&(뒤로) 미루다|difer/différer&(속도를)
늦추다
지연시키다|slow/ralentir&다다르다|gain/gagner&(어디에) 이르다|reach/parvenir à&도착하다|arrive/arriver&다듬다
손질하다|polish/peaufiner&(머리 따위를)
다듬다
손질하다|trim/couper&(음식 재료 따위를)
다듬다
손질하다|prepare/préparer&(초목, 암석 따위를)
다듬다
손질하다|trim/tailler&정제[제련]하다|refine/raffiner&(사람을) 다루다|deal with/s'occuper de&(주제 따위를) 다루다|treat/traiter&(물건 따위를) 다루다, 취급하다|handle/manier&(기계 따위를) 다루다, 조작[조종]하다|manipulate/manipuler&(마음대로 부리어) 조작[조종]하다|manipulate/manipuler&다르다
달라지다
상이[판이]하다|differ/différer&다리를 절다|limp/boiter&다시 나타나다
재등장하다
재출현하다|reappear/reparaître&(오랜 공백 끝에)
다시 나타나다
재등장하다
재출현하다|surface/refaire surface&다시 하다|redo/refaire&되풀이하다
반복[중복]하다|repeat/répéter&다양하다
분분하다
다채롭다|vary/varier&다지다
견고[공고]하게 하다|confirm/confirmer&튼튼하게 하다|strengthen/conforter&돈독하게 하다|cement/cimenter&(육체적 또는 심리적으로)
다치게 하다
상하게 하다
상처를 내다|hurt/blesser&다치다
상하다
상처를 입다|get hurt/se faire mal&닦다|wipe/essuyer&(상태가 변하여) 되다|pass to/passer à&단련하다|train/exercer&단련하다
벼리다|forge/forger&단물을 빨아먹다
가장 크고 좋은 몫을 차지하다|take the lion's share/se tailler la part du lion&달려 있다|depend on/dépendre de&달리다
뛰다|run/courir&달려오다
뛰어오다|come running/accourir&결실을 맺다|bear fruit/porter ses fruits&달이다
우려내다|infuse/infuser&(장소 따위에)
달하다
도달[달성]하다|attain/atteindre&(수량 따위가)
달하다|amount to/s'élever à&닮다
비슷[유사]하다|resemble/ressembler à&답습하다|follow/reprendre&답하다
대꾸[대답]하다
부응[응답]하다|respond/répondre à&개막식을 열다
개통식을 열다|inaugurate/inaugurer&전도[도치]시키다|invert/inverser&당기다
잡아당기다|pull/tirer&(팽팽하게)
당기다
잡아당기다|tug at/tirailler&끌어당기다
유인하다|attract/attirer&견인하다|tow/tracter&당황하게 하다
당혹스럽게 하다
난처[곤란]하게 하다
곤경에 처하게 하다|embarrass/embarrasser&어이없게 하다
어리둥절하게 하다|confound/confondre&대가를 치르다|pay the price/faire les frais&대동하다
함께 있다
같이 있다|accompany/accompagner&대상이 되다|be the object of/faire l'objet de&대신하다
대치하다
대체[교체]하다|replace/remplacer&치환하다|substitute/substituer&대리하다|represent/représenter&대질시키다|confront/confronter&대처하다|manage/gérer&대표하다
대변하다|represent/représenter&대피시키다
피난[피신]시키다|evacuate/évacuer&대하다
취급하다
대접[대우]하다|treat/traiter&더는 못하겠다|can't stand it anymore/n'en pouvoir plus&더럽히다|get dirty/salir&오염시키다|pollute/polluer&더하다
보태다
추가하다|add/ajouter&합산하다
합계를 내다|total/totaliser&던지다|throw/jeter&투척하다|throw/lancer&내던지다|project/projeter&내팽겨치다
내동댕이치다|fling/lancer&덜어주다|relieve/soulager&탕감하다|write off/remettre&덫에 걸리게 하다
함정에 빠뜨리다|trap/piéger&덮치다|leap at/bondir sur&뛰어들다
달려들다|run into/courir dans&(자신의 몸을 던지어)
뛰어들다
달려들다|throw oneself at/se jeter sur&돌진하다|rush at/se ruer sur&돌격하다|charge/charger&데려다주다|take back/ramener&내려주다|drop/déposer&배웅하다
바래다주다|see off/raccompagner&따뜻하게 하다|warm up/réchauffer&데우다
덥히다|heat/chauffer&달아나다
도망가다|flee/fuir&탈출[도피]하다|escape/fuir&탈주[탈옥]하다|evade/s'évader&탈영하다|desert/déserter&튀다|bolt/se casser&꽁무니를 빼다|chicken out/caner&도식화하다|draw a diagram of/schématiser&도입하다
들여오다|introduce/introduire&독점하다|monopolise/avoir le monopole de&독차지하다|have all to oneself/occuper à lui seul&돌다
회전하다|turn/tourner&(삥)
한 바퀴 돌다|take a round/faire un tour&(빙빙)
맴돌다|swirl/tournoyer&돌아다니다|get around/faire un tour&순방[순회]하다|tour/faire la tournée&돌려보내다|send back/renvoyer&반송[반품]하다|return/retourner&돌려주다|give back/rendre&반환하다|return/restituer&(영토 따위를)
반환하다|retrocede/rétrocéder&(기계 따위를) 돌리다|run/tourner&작동[가동]시키다|operate/mettre en opération&돌보다
보살피다|look after/s'occuper de&(기계 따위가)
돌아가다|work/marcher&작동[가동]되다|function/fonctionner&(무언가 또는 누군가가)
돕다
도와주다
지원하다|help/aider&(무언가가)
돕다
도와주다
지원하다|facilitate/faciliter&(누군가 또는 무언가를)
지지하다|support/supporter&(무언가를)
지지하다|endorse/avaliser&후원하다|sponsor/patronner&거들다|give a hand/donner un coup de main&도움을 주다|help out/rendre service&보조[보좌]하다|assist/assister&동그라미를 치다|circle/encercler&동기를 부여하다|motivate/motiver&동반하다
수반하다|accompany/accompagner&동행하다
함께 가다
같이 가다|accompany/accompagner&동화시키다|assimilate/assimiler&되돌리다
되돌아오게 하다|bring back/ramener&되돌아가다|go back/retourner&(어떠한 상태로) 되돌아가다|revert to/retomber en&유턴하다|make a U-turn/faire demi-tour&되돌아오다
복귀하다
컴백하다|be back/retourner&귀가하다|go back home/rentrer&되살리다
소생시키다|revive/raviver&부활시키다|resurrect/ressusciter&부흥시키다|make reborn/faire renaître&활력을 되찾게 하다
다시 활기를 띄게 하다|refresh/rafraîchir&겁주다|scare/faire peur à&굴복시키다
순종[복종]시키다
복속시키다|subject/soumettre&굴복하다
순종[복종]하다
복속되다|obey/obéir à&순응하다|comply with/se conformer à&굽히다
굴하다|give in to/céder à&되찾다
돌려받다|get back/retrouver&(저당물 따위를)
되찾다
돌려받다|redeem/récupérer&탈환하다|retake/reprendre&회수[회복]하다|recover/récupérer&두각을 보이다
두드러지다|distinguish oneself/se distinguer&두려워 하다
무서워 하다|fear/craindre&두렵게 하다
무섭게 하다|terrify/terrifier&공포스럽게 하다|panic/paniquer&둘러싸다
에워싸다|surround/entourer&두르다|wrap/enrouler&(울타리 따위를) 두르다|enclose/entourer&감싸다|wrap/enrouler&(누군가를 또는 누군가의 허물 따위를) 감싸다|cover up for/couvrir&포위하다|besiege/assiéger&뒤집다
뒤집어놓다|overturn/retourner&(위아래로)
뒤집다
뒤집어놓다
뒤엎다
뒤집어엎다|turn upside down/retourner&(근본적으로 바꾸어)
뒤집다
뒤집어놓다
뒤엎다
뒤집어엎다|turn upside down/bouleverser&역전하다|reverse/renverser&전복시키다|overthrow/renverser&뒷받침하다|back up/appuyer&뒷전으로 밀려나다|take a back seat/passer au second plan&뒹굴다|roll/se rouler&드러나다|emerge/émerger&밝혀지다
폭로[누설]되다|come to light/se faire jour&드러내다|show/montrer&밝히다
폭로[누설]하다|reveal/révéler&득점하다|score/marquer un but&듣다|listen to/écouter&들리다|hear/entendre&들끓다
우글[득실]거리다|infest/infester&들다
들어올리다|raise/lever&(수고를 들이어)
들다
들어올리다|lift/soulever&(특히 신체 따위를)
들다
들어올리다|raise/dresser&들다
들고 있다|carry/porter&들다
소요되다|demand/demander&들려주다|let hear/faire entendre&들르다|drop by/passer&경유하다|transit for/transiter par&들먹이다|invoke/invoquer&등록하다|register/enregistrer&디지털화하다|digitise/numériser&따갑게 하다
따끔거리게 하다|prickle/picoter&따르다
따라가다
따라오다|follow/suivre&(말 따위를)
따르다
듣다|follow/suivre&땀을 흘리다|sweat/suer&두드리다|knock/frapper&(톡톡) 두드리다|tap/taper&때리다|hit/battre&치다|strike/frapper&가격하다|strike/donner un coup&떠나다|leave/quitter&출발하다|depart/partir&능가하다|outdo/devancer&갖추다
갖추고 있다|have/avoir&갖추다
마련하다|prepare/préparer&(계획 따위를)
갖추다
마련하다|arrange/arranger&(대책 따위를)
갖추다
마련하다|put in place/mettre en place&대비하다|provide for/prévoir&준비하다
채비하다|prepare/préparer&떠돌다
방황[방랑]하다|wander/errer&배회하다
돌아다니다|roam/vagabonder&서성거리다
어슬렁거리다|loiter/traîner&떠벌리다|gossip/bavarder&떠오르게 하다
상기[환기]시키다
연상[회상]시키다|remind/rappeler&떠오르다
생각나다|come to mind/venir à l'esprit&떠오르다
부상하다|emerge/émerger&떨어뜨리다
놓치다|drop/faire tomber&투하하다|drop/larguer&격추시키다|shoot down/abattre&떨어뜨리다
탈락시키다|eliminate/éliminer&실격시키다|disqualify/disqualifier&떨어뜨리다
떼어놓다|separate/séparer&멀리 하다
멀어지게 하다|take away/éloigner&들이대다
가까이 하다
가까워지게 하다|bring close/approcher&들이대다
꼬시다
작업걸다|pick up/draguer&떨어지다
추락하다|fall/tomber&(항공기가)
떨어지다
추락하다|crash/se crasher&급락[폭락]하다|plunge/s'effondrer&떨어지다
낙제하다|fail/rater&떼다|detach/détacher&같다
똑같다
마찬가지다
매한가지다|equal/valoir&동일[동등]하다
대등[균등]하다|equal/équivaloir à&똑같이 하다|do the same/faire de même&똥을 싸다|crap/chier&배설하다|excrete/excréter&(구멍을)
뚫다
꿰뚫다|pierce/percer&(관 따위를)
뚫다
꿰뚫다|unblock/désengorger&꿰뚫어보다|see through/percer&관통하다|penetrate/pénétrer&돌파하다
뚫고 나아가다|break through/percer&뛰다
점프하다|jump/sauter&도약하다
뛰어오르다|leap/bondir&뛰다
두근대다|beat/battre&뛰어나다
탁월하다|excel/exceller&뜨다
떠 있다
떠다니다|float/flotter&마법을 걸다|enchant/enchanter&마비시키다
감각이 없게 만들다|paralyse/paralyser&(교통 따위를)
마비시키다|disturb/perturber&뛰어들다
뛰어내리다|jump off/sauter&(물속에)
뛰어들다
뛰어내리다|dive into/plonger dans&(일 따위에)
뛰어들다|plunge into/plonger dans&마음껏 하다
한껏[실컷] 하다|indulge in/se faire plaisir avec&마음에 들다|please/plaire à&마시다|drink/boire&흡입하다|inhale/inhaler&마음을 다잡다
착실히 살다|settle down/se ranger&마음이 생기게 하다
내키게 하다
구미가 당기게 하다|tempt/tenter&마주보게 하다
직면[대면]하게 하다|confront/confronter&마주보다
직면[대면]하다|face up to/faire face à&마중 나오다|come to pick up/venir chercher&막다
차단하다|block/bloquer&(구멍 따위를)
막다
차단하다|plug/boucher&(길 따위를)
막다
차단하다|close/fermer&가로막다|intercept/intercepter&봉쇄[폐쇄]하다|block/bloquer&막다
못하게 하다
할 수 없게 하다|prevent/empêcher&막을 열다
시작을 알리다|inaugurate/inaugurer&막 하려던 참이다|be about to/être sur le point de&만나다|meet/voir&다시 만나다|get back to/retrouver&마주치다
우연히 만나다|run into/rencontrer&접촉하다|contact/contacter&(공들여, 정성껏) 만들다|elaborate/élaborer&창조[창작]하다|create/créer&발명하다
고안[창안]하다|invent/inventer&빚다|model/modeler&형성[구성]하다|form/former&생성하다
발생시키다|generate/générer&생산[산출]하다|product/produire&만료되다
만기가 되다
기한이 지나다|expire/expirer&(무언가를 또는 누군가를)
만족시키다
충족시키다|satisfy/satisfaire&(무언가를)
만족시키다
충족시키다|meet/répondre à&(누군가를)
만족시키다
충족시키다|content/contenter&만지다|touch/toucher&만지작거리다|play with/tripoter&만회하다|make up for/se rattraper&말리다
건조시키다|dry/sécher&말리다|stop/arrêter&만류하다|dissuade/dissuader&말을 걸다|address/adresser la parole&말을 끊다
말을 가로막다|interrupt/interrompre&진술하다|state/déclarer&언급하다|mention/mentionner&발언하다|remark on/faire remarquer&맑게 하다|clear/éclaircir&정화하다|purify/purifier&맛보다|taste/goûter&시식[시음]하다|try/essayer&망가뜨리다|break/casser&훼손시키다|mutilate/mutiler&손상[파손]시키다|damage/endommager&기분이 좋아지다|feel better/se sentir mieux&상대하다|deal with/s'occuper de&들어가다
들어오다
입장하다|enter/entrer&난입하다|invade/envahir&못 쓰게 만들다|mutilate/mutiler&망설이다
주저[고민]하다|hesitate over/hésiter sur&망치다|spoil/gâter&잡치다|screw up/foutre en l'air&조지다|cock up/merder&그르치다|ruin/ruiner&결딴내다|wreck/massacrer&망하다|fail/échouer&좇되다|be in the shit/être dans la merde&몰락하다|ruin/se ruiner&(예감 따위가)
맞다
적중하다|come true/se realiser&맞다
맞이하다
접대하다
대접[접견]하다|receive/recevoir&맞서다
상대하다|face up to/faire face à&(정면으로)
맞서다
상대하다|face/faire front à&(용감히)
맞서다
상대하다|brave/braver&도전하다|challenge/défier&무릅쓰다
각오하다|risk/risquer&대적하다|oppose/s'opposer à&(부품 따위를) 맞추다|put together/monter&(시계 따위를) 맞추다|set/mettre&조립하다|assemble/assembler&조절하다|regulate/réguler&조정하다|adjust/ajuster&(목표물 따위를)
맞히다
적중시키다|hit/atteindre&맞히다
알아맞히다|guess/deviner&맞히다
바로 맞히다|get it right
y arriver&맡기다|leave/laisser&(책임, 임무 따위를) 맡기다|charge/charger&일임하다|give carte blanche/donner carte blanche&위임하다|mandate/donner mandat à&위탁하다|consign/consigner&의뢰하다|commission/commissionner&위촉[선임]하다
임명[지명]하다|appoint/nommer&(냄새를) 맡다|smell/sentir&(임무 따위를) 맡다|take/prendre&떠맡다|take on/endosser&담당하다|assume/assumer&매수되다|sell out/se vendre&맹세하다|swear/jurer&서약하다|take an oath/prêter serment&(관계 따위를) 맺다|build/nouer&(계약 따위를)
맺다
체결하다|conclude/conclure&머물다
머무르다
지내다|stay/rester&체류[투숙]하다|stay/séjourner&(맛있게) 먹다|enjoy/se régaler&(마음껏, 자유로이) 먹다|help oneself to/se taper&(게걸스럽게) 뜯어먹다|devour/dévorer&처먹다
마구 먹다|guzzle/bâfrer&섭취하다|intake/se nourrir&갉아먹다|gnaw/ronger&핥아먹다|lap/laper&깨작거리다
주전부리하다|nibble/grignoter&먹여살리다
부양하다|provide for/subvenir aux besoins de&먹이다|feed/nourrir&복용시키다
투여[투약]하다|administer/administrer&멀어지다|get away from/s'éloigner de&멈추다
그치다
그만두다|stop/arrêter&정지하다|stop/arrêter&중단[중지]하다|interrupt/interrompre&메스껍다
구토가 나다
느글느글[니글니글]하다|feel nausea/avoir la nausée&면제하다|exempt/exempter&멸망하다|fall/s'effondrer&명상하다
사색하다|meditate/méditer&명심하다|keep in mind/garder à l'esprit&명하다
명령하다|order/ordonner&명확하게 하다
명시[명기]하다|specify/préciser&모금하다
기부금을 모으다|raise funds/quêter&아직은 모른다
두고 봐야 안다
두고 볼 일이다|remain to be seen/rester à savoir&모방하다|imitate/imiter&따라하다
흉내내다|mime/mimer&헐뜯다|malign/médire de&욕하다
욕설하다|insult/insulter&마사지하다|massage/frictionner&모독하다|abuse/outrager&모욕[굴욕]을 주다
치욕[곤욕]스럽게 하다|humiliate/humilier&모으다|gather/rassembler&수집[수거]하다|collect/collecter&무리 지어 모으다
뭉치게 하다|group/grouper&모집하다|recruit/recruter&규합하다|rally/rallier&집합시키다|assemble/rassembler&밀집시키다|concentrate/concentrer&단결시키다
집결[결집]시키다|rally/rallier&목을 베다|cut one's throat/égorger&참수하다|behead/décapiter&목욕하다|take a bath/prendre un bain&(누군가가)
몰리다
몰려들다
모여들다
쇄도[운집]하다|rush/se ruer&(누군가 또는 무언가가)
몰리다
몰려들다
모여들다
쇄도[운집]하다|converge/affluer&무관심하다|don't pay enough attention to/ne pas faire assez attention à&무겁게 하다
가중시키다|aggravate/aggraver&무너뜨리다
쓰러뜨리다
주저앉히다|knock down/faire tomber&붕괴시키다|collapse/effondrer&와해시키다|collapse/effondrer&무너지다
쓰러지다
주저앉다|fall/tomber&(지쳐)
무너지다
쓰러지다
주저앉다|crack/craquer&붕괴[와해]되다|collapse/s'effondrer&무릎을 꿇다|fall to one's knees/tomber à genou&무리하다
혹사[과로]하다|overwork/forcer&무시하다
모르는 체하다
못본 체하다|ignore/ignorer&무시하다
업신여기다
깔보다|look down on/mépriser&무시하다
경멸[멸시]하다|despise/mépriser&만만하게 여기다
대수롭지 않게 여기다|pay little attention/faire peu de cas&무역하다
교역하다|trade/commercer&묵게 하다|let stay/loger&숙박[유숙]시키다|accommodate/héberger&묵다|stay/loger&묵인하다|connive/être de connivence de&숙박[유숙]하다|lodge/faire étape&눈 감아주다
못 본 체 하다|turn a blind eye to/fermer les yeux sur&묶다
매다|tie/lier&(끈으로)
묶다
매다|lace/ficeler&(매듭을)
묶다
매다|knot/nouer&(배 따위를 항구에)
묶다
매다|moor/amarrer&묻다
물어보다
질문하다|ask/demander&문지르다
비비다|rub/frotter&문의하다|enquire about/se renseigner sur&묻다
매장하다|bury/enterrer&물다
깨물다|bite/mordre&물들이다
염색하다
색을 칠하다|dye/teindre&뒷걸음치다|step back/reculer&(어떠한 자리에서)
물러나게 하다|depose/déposer&해직[해임]하다|dismiss/démettre&물러나게 하다
물리다|push back/repousser&(어떠한 자리에서)
물러나다|retire/se retirer&사퇴하다
사직[사임]하다|resign/démissionner&물러나다
물러서다|step back/reculer&후퇴[퇴각]하다|retreat/se replier&철수[철군]하다|withdraw/se retirer&격퇴하다|repel/refouler&물을 주다
물을 뿌리다|water/arroser&묽게 하다|thin/allonger&희석하다|dilute/diluer&뭉뚱그리다
똑같이 취급하다
싸잡아 취급하다|lump together/faire l'amalgame avec&미끼를 달다|bait/amorcer&미진하다
아쉬운 점이 많다|leave a lot to be desired/laisser à désirer&미치게 만들다
제정신이 아니게 만들다|madden/affoler&미치다
정신이 나가다
실성[환장]하다|lose one's mind/perdre la raison&미화하다
아름답게 하다|beautify/embellir&믿게 하다
확신시키다
확실하게 하다|ensure/assurer&믿다|believe/croire à&확신하다
확실하게 여기다|be convinced of/se convaincre de&신뢰[신임]하다|trust/faire confiance à&밀다
밀치다|push/pousser&밀어내다|push back/repousser&밑줄을 긋다|underline/souligner&바꾸다
갈다|change/changer&변화시키다|change/changer&변형시키다|deform/déformer&변신시키다|transform/transformer&변모시키다
탈바꿈시키다|metamorphose/métamorphoser&기대[고대]하다|expect/s'attendre à&바라다
좋겠다
희망하다
소원[소망]하다|wish/espérer&염원하다
동경[열망]하다|aspire to/aspirer à&리모델링하다|remodel/rénover&고치다
수리하다
수선[보수]하다|repair/réparer&(자세 따위를)
고치다
바로잡다|straighten/redresser&(잘못 따위를)
고치다
바로잡다|put right/rétablir&바르다
칠하다|apply/appliquer&바치다|devote/vouer&헌정하다|dedicate/dédier&헌신하다
몸을 바치다|devote oneself to/se dévouer à&박다
박아넣다|drive/enfoncer&박수갈채를 보내다|applaud/applaudir&박수치다
손뼉치다|clap/frapper des mains&박피하다
가죽을 벗기다|skin/dépouiller&반격하다
역습하다|counterattack/contre-attaquer&반대하다|oppose/s'opposer à&(무엇을 근거로 들어) 반대하다|object/objecter&반등하다|rally/bondir&급반등하다|rally sharply/rebondir&반박하다|contradict/contredire&반발하다|resist/résister à&반사하다
반영하다|reflect/refléter&반향시키다|reverberate/répercuter&반성하다|reflect on/réfléchir à&반역하다
반란을 일으키다|rebel/se rebeller&반응하다|react to/réagir à&반하다
사랑에 빠지다|fall for/tomber amoureux de&받다|receive/recevoir&(특히 전화 따위를) 받다|pick up/décrocher&받아내다
얻어내다|get out of/arracher&수신[수령]하다|receive/recevoir&고치다
수정하다|correct/corriger&개정하다|revise/réviser&변경하다|modify/modifier&교정[정정]하다|rectify/rectifier&받아들이다
수락하다|accept/accepter&감수하다|accept/accepter&영입하다|enrol/enrôler&포용하다|tolerate/tolérer&수용하다|receive/recevoir&(어떠한 공간에) 수용하다|accommodate/héberger&(공리 목적으로 토지 따위를) 수용하다|expropriate/exproprier&만하다
마땅하다
자격[가치]이 있다|deserve/mériter&계발하다
발전[발달]시키다|develop/développer&받치다|rest/appuyer&지탱하다|support/supporter&발음하다|pronounce/prononcer&조음하다
또박또박 발음하다|articulate/articuler&발이 넓다
인맥이 많다|have a large social circle/avoir le bras long&발표하다|announce/annoncer&(프레젠테이션 따위를) 발표하다|give a presentation/faire un exposé&발효되다
유효해지다|take effect/prendre effet&발흥하다
부상하다|rise in power/monter en puissance&발휘하다|display/déployer&밝히다
밝게 하다
비추다
환하게 하다|lighten/éclaircir&(사실 따위를) 밝히다|clear up/éclaircir&해명[규명]하다|elucidate/élucider&분명[명백]히 하다|clarify/clarifier&누설[폭로]하다|reveal/révéler&밤을 새다
밤샘하다|stay up all night/faire nuit blanche&방귀를 뀌다|fart/péter&방문하다|visit/visiter&드나들다
자주 방문하다|frequent/fréquenter&방송하다
방영하다|broadcast/émettre&방해하다|disturb/déranger&저해하다|hinder/entraver&귀찮게 하다
성가시게 하다|bother/embêter&걸리적거리게 하다
거추장스럽게 하다|encumber/encombrer&방향을 잡다|take a direction/prendre une direction&돌리다
선회하다|circle/virer&(본체가) 방향을 바꾸다|deflect/dévier&우회하다|detour/contourner&(본체의) 방향을 바꾸다|deflect/dévier&우회시키다|divert/détourner&굴절시키다|refract/réfracter&배달하다|deliver/livrer&배부르게 먹다|fill up/se rassasier&실컷 먹다
배 터지게 먹다|stuff oneself/se gaver&과식하다
포식[폭식]하다|binge/s'empiffrer&배신하다|betray/trahir&바람피우다|cheat on/tromper&배열하다|arrange/arranger&배우다|learn/apprendre&배출하다|discharge/dégager&(생리적으로)
배출하다|evacuate/évacuer&(인물 따위를)
배출하다|produce/produire&뱃머리를 돌리다
노선을 변경하다|change course/changer de cap&뱉다|spit/cracher&베다|cut/couper&(단칼에) 베다|slice/trancher&버리다|throw away/jeter&저버리다|betray/trahir&버리다
유기하다|abandon/abandonner&손절하다|cut off/laisser tomber&번식시키다|breed/reproduire&번역하다|translate/traduire&번영하다
번창[번성]하다|prosper/prospérer&융성[성행]하다|flourish/fleurir&내보내다|let out/renvoyer&(돈 따위를) 벌다|earn/toucher&벌리다|spread/écarter&(시합 따위가)
벌어지다
치뤄지다|take place/se disputer&법제화하다
법률을 제정하다|legislate/légiférer&벗다|pull off/retirer&(옷 따위를) 풀다|undo/défaire&벗어나다
헤어나다|get out of/quitter&빠져나가다
빠져나오다|free oneself/se dégager&벗어나다
빗나가다
엇나가다|deviate/dévier&바뀌다
변하다
변화하다|turn to/se changer en&(다른 곳으로) 내보내다|send out/envoyer&변동하다|fluctuate/fluctuer&변함없다|remain the same/rester la même&변혁을 일으키다
혁신을 일으키다|revolutionise/révolutionner&변호하다|plead/plaider&별명을 붙이다|nickname/surnommer&보내다
보내오다|send/envoyer&(우편물 따위를)
보내다
보내오다|address/adresser&이송하다
운송[수송]하다|transport/transporter&파견하다|dispatch/envoyer&배송[발송]하다|expedite/expédier&전송[송부]하다
송신[발신]하다|transmit/transmettre&시간을 보내다|pass the time/passer le temps&(언뜻, 잠시) 보다|glimpse/entrevoir&(지각에 의해) 보다|see/voir&(의식을 갖고) 바라보다|watch/regarder&목격하다|witness/assister à&직시하다|face up to/faire face à&응시하다|fix one's eye on/fixer les yeux sur&주시하다|keep an eye on/garder un œil sur&보다
여기다|take/prendre&(무언가라고) 생각하다|consider/considérer&(탓, 공, 책임 따위로)
돌리다
전가하다|attribute/attribuer&간주하다|regard/regarder&보이다
보여주다|show/montrer&노출하다|expose/exposer&보이다|seem/sembler&보장하다
확보하다|assure/assurer&보증하다|guarantee/garantir&장담하다|bet/parier&단언[확언]하다|affirm/affirmer&보조금을 주다|subsidise/subventionner&보상하다
보답[사례]하다|recompense/récompenser&보상하다
배상[변상]하다|indemnify/indemniser&(비교적 경미한 손실에 대하여)
보상하다
배상[변상]하다|recompense/récompenser&복무하다
군복무를 하다
병역을 이행하다|do one's military service/faire son service militaire&복수[보복]하다|avenge/venger&복습하다|revise/réviser&복원하다
복구하다|restore/restaurer&복잡하게 만들다
까다롭게 만들다|complicate/compliquer&복제하다|reproduce/reproduire&복직하다|return to one's job/retrouver son emploi&(밥 따위를) 볶다|fry/sauter&(커피 따위를) 볶다|roast/griller&봉기하다
반기를 들다
들고 일어나다|rise up/se soulever&봉사하다|volunteer/faire du volontariat&부결시키다|reject/rejeter&부담시키다
부과하다|charge/charger&과부하시키다|overload/surcharger&부담을 덜어주다|relieve/décharger&부담하다|bear/se charger de&책임지다|take responsibility/porter une responsabilité&짊어지다|support/supporter&들이받다|hit/percuter&(실체가)
부딪치다
충돌하다|bang into/se cogner à&(실체 또는 관념이)
부딪치다
충돌하다|collide with/se heurter à&부러뜨리다
분지르다|break/casser&부러워하다|envy/envier&부르다|call/appeler&명명하다|name/nommer&부수고 들어가다|force/forcer&부수다|break/briser&허물다
파괴하다|destroy/détruire&(문화, 예술 따위를)
허물다
파괴하다|vandalise/vandaliser&산산조각내다|shatter/fracasser&부식시키다|corrode/corroder&부유하게 하다|enrich/enrichir&부정하다
부인하다|deny/nier&부족하다
모자라다|lack/manquer&교사하다
사주하다|provoke/provoquer&도발하다|provoke/provoquer&선동하다|incite/inciter&부추기다|kindle/attiser&불난 데 기름을 붓다
부채질하다|fuel/allumer&시키다|push/pousser&부탁하다|ask for/demander&청하다
당부하다
해달라 하다|pray/prier&빌다
간청하다
제발[부디] 해달라 하다|beg/supplier&애원[애걸]하다|plead with/implorer&호소[촉구]하다|appeal for/appeler&부화하다
알에서 깨어나다|hatch/éclore&북돋우다|boost/réchauffer&격려[독려]하다|encourage/encourager&고무[고취]하다|stimulate/stimuler&분석하다|analyse/analyser&분쇄하다|pulverise/pulvériser&분열시키다|divide/diviser&(은유적으로) 분열시키다|fracture/fracturer&변장시키다
가장시키다|disguise/déguiser&분장시키다|disguise/déguiser&위장시키다|camouflage/camoufler&(바람 또는 입김을)
불다|blow/souffler&(나팔 따위를)
불다|blow/souffler&(바람 따위가) 
불다|blow/souffler&(군사를)
불러모으다
소집하다|call up/appeler&(회의 따위를)
불러모으다
소집하다|convene/convoquer&동원하다|mobilise/mobiliser&불만스럽게 하다
마음에 들지 않게 하다|displease/mécontenter&불쌍히 여기다
안타까워 하다|feel sorry for/plaindre&연민을 느끼다|commiserate with/compatir à&동정하다|pity/s'apitoyer sur&불법화하다
범죄화하다|criminalise/criminaliser&불신하다|mistrust/se méfier de&불안정하게 하다|destabilise/déstabiliser&불안하게 하다
걱정시키다|worry/inquiéter&동요시키다|agitate/agiter&마음 쓰이게 하다|worry/préoccuper&근심하게 하다
우려[염려]하게 하다|concern/angoisser&불안해하다
걱정하다|worry about/s'inquiéter de&근심하다
우려[염려]하다|have concern about/craindre&(잠금장치를 하여) 
묶다
매다|fasten/attacher&불어닥치다
휘몰아치다|rage/faire rage&(전등 따위의)
불을 켜다|turn on the light/allumer&불을 붙이다
불을 지르다|set fire/mettre le feuㅂ&점화하다|ignite/allumer&방화하다|set alight/incendier&불참하다
결석[결근]하다|do not attend/ne pas assister à&빼먹다|skip/sécher&불쾌하게 하다
기분을 상하게 하다|offend/offenser&불평하다
투덜대다|complain/se plaindre&부풀리다|inflate/gonfler&붐비다
북적대다|crowd/se presser&붓다
부어오르다|swell/se bouffir&붓다
따르다|pour/verser&퍼붓다|rain/faire pleuvoir&붕대를 감다|bandage/panser&붙다
들러붙다
달라붙다|adhere to/adhérer à&불러일으키다|provoke/provoquer&끼치다
초래하다|cause/causer&촉발하다
야기하다|trigger/déclencher&일으키다
자아내다|raise/soulever&생기게 하다
계기가 되다|give rise to/donner naissance à&유발[유도]하다|inspire/inspirer&붙이다|paste/coller&덧붙이다|add/ajouter&첨부하다|attach/joindre&부착하다|attach/attacher&못마땅해 하다
탐탁찮아 하다|disapprove of/désapprouver&비공개하다|make private/rendre privé&비교하다|compare/comparer&대조하다|contrast/faire contraster&비꼬다|have a dig at/ironiser sur&비난하다|accuse/accuser&규탄하다|denounce/dénoncer&비판하다|critique/critiquer&혹평하다|fustigate/fustiger&폄하하다|denigrate/dénigrer&깎아내리다
비하[비방]하다|belittle/rabaisser&놀리다|mock/se moquer de&비우다|empty/vider&비웃다|laugh at/se rire de&조롱하다|ridicule/ridiculiser&우롱하다|befool/bafouer&야유하다|boo/huer&비키다|step aside/se pousser&빈축을 사다
물의를 빚다|scandalise/scandaliser&(소원 따위를) 빌다|wish/souhaiter&기원하다|invoke/invoquer&빌려주다
꿔주다|lend/prêter&대여하다|rent/louer&대출해주다|loan/prêter&빌리다
꾸다
끌어오다
차용하다|borrow/emprunter&인용하다|cite/citer&빗맞히다|miss/manquer&빚지고 있다
갚아야 하다|owe/devoir&빛나다|shine/briller&빠뜨리다|put/plonger&빠뜨리다
누락[생략]하다|miss/manquer&빠지다|fall in/tomber en&빠져들다|get stuck in/s'enliser dans&(부정적인 것에) 빠져들다|sink into/sombrer dans&빨다
빨아먹다|suck/sucer&빨아들이다|suck up/aspirer&(나쁜 상태에) 빠뜨리다|precipitate/précipiter&빨래를 하다|do the laundry/faire la lessive&빨리 하다
빠르게 하다|rush/activer&서두르다
급히 하다|hurry up/hâter&빻다
찧다
으깨다|grind/broyer&(밖으로) 빼다|get out of/enlever&(밖으로) 빼내다|pull out/retirer&빼다
공제[선취]하다|deduce/déduire&빼앗다|take/prendre&앗아가다|take away/enlever&가로채다|intercept/intercepter&박탈하다|deprive/priver&뜯어내다|squeeze/soutirer&강탈하다
갈취[탈취]하다|extort/extorquer&편취[사취]하다|cheat/escroquer&내뿜다
발산하다|emit/émettre&달다|put/mettre&설치하다|install/installer&뻔뻔하게 하다|have the nerve to/avoir l'aplomb de&뻗다|stretch/étendre&뽑다
뽑아내다|pull/tirer&인출하다|withdraw/retirer&채취하다|take/prélever&발췌하다
추출[도출]하다|extract/extraire&뽑다
선출하다|elect/élire&추첨하다
제비를 뽑다|draw lots/tirer au sort&뿌리내리게 하다|root/enraciner&(씨 따위를) 뿌리다|sow/semer&(액체 따위를)
뿌리다
살포하다|spray/vaporiser&(금품 따위를)
뿌리다
살포하다|distribute/distribuer&(소문 따위를)
뿌리다
유포하다|circulate/faire circuler&뿌리뽑다
근절[박멸]하다|eradicate/éradiquer&삐지다
토라지다
뾰로통하다|sulk/bouder&사과하다
미안[죄송]하다|apologise/s'excuser&사귀다
교제하다|date/sortir avec&사기치다|swindle/arnaquer&사냥하다|hunt/chasser&사로잡다|captivate/conquérir&휩싸다
엄습하다|sweep/frapper&시달리게 하다|bother/travailler&사로잡히다
시달리다|suffer/souffrir&사면하다
특사하다|pardon/gracier&사문화되다|be a dead letter/rester lettre morte&사업을 하다
장사를 하다|do business/faire des affaires&사유화하다
개인화하다|personalise/personnaliser&민영화하다|privatise/privatiser&사이가 좋다|get along well/s'entendre bien&말이 잘 통하다
마음이 잘 통하다|speak the same language/parler la même langue&사주다
한턱 내다
비용을 대다|pay/payer&개혁하다|reform/réformer&주의를 산만하게 하다
주의를 흩뜨리다|distract/distraire&산업화하다
공업화하다|industrialise/industrialiser&산책하다|take a walk/faire une promenade&살다|live/vivre&거주[주거]하다|inhabit/habiter&(법적으로)
거주[주거]하다|reside/résider&살찌우다|fatten/faire grossir&살펴보다|examine/examiner&(주의 깊게)
살펴보다|take stock of/faire le point sur&(부글부글)
끓이다
삶다|simmer/mitonner&끓이다
삶다|boil/bouillir&삼가다|abstain from/s'abstenir de&절제하다|restrain/modérer&자제[자중]하다|restrain oneself/se modérer&삼키다|swallow/avaler&(꿀꺽) 삼키다|gulp down/gober&상상하다|imagine/imaginer&항소하다|appeal against/appeler de&상쇄하다
벌충하다|compensate/compenser&상징하다|symbolise/symboliser&상한을 설정하다|cap/plafonner&상호 공유하다|share with each other/mutualiser&새기다|inscribe/inscrire&새다
유출되다|leak/fuir&새로이 하다
갱신하다
일신[쇄신]하다|renew/renouveler&생각을 바꾸다|change one's mind/se raviser&생각하다|think/penser&(마음 속으로) 생각하다|say to oneself/se dire&하고자 하다
할 작정이다|intend to/avoir l'intention de&생존하다
살아남다|survive/survivre&생애를 보내다|live one's life/mener sa vie&샤워하다|shower/se doucher&서다
서 있다|stand/se tenir debout&일어서다
일어나다|stand up/se lever&서로 돕다
상부상조하다|help each other/s'entraider&서로 연이 끊어지다|lose touch with each other/se perdre de vue&서명하다
조인하다|sign/signer&섞다
뒤섞다|mix/mêler&(불순물을)
섞다
뒤섞다|adulterate/frelater&혼합하다|compound/mélanger&선수를 치다
주도권을 잡다|take the initiative/prendre l'initiative&선을 넘다
정도를 넘다|cross the line/dépasser la mesure&선포하다|proclaim/proclamer&(법령에 의해)
선포하다|decree/décréter&묘사하다|describe/décrire&서술하다
기술하다|describe/décrire&가설[부설]하다|lay/poser&선행을 하다
선을 행하다|do good/faire le bien&설거지하다|do the dishes/faire la vaisselle&설교하다|preach/prêcher&설득하다
납득시키다|convince/convaincre&설명하다|explain/expliquer&신경 쓰이게 하다|annoy/ennuyer&폐를 끼치다|trouble/troubler&성장시키다|grow/accroître&섬기다
모시다|serve/servir&숭배하다|venerate/vénérer&성공하다|succeed in/réussir&해내다|get to/arriver à&(혼자서 용캐) 해내다|manage/se débrouiller&열심이다|have a lot of courage/avoir du courage&잘 하다
잘 해나가다|manage/gérer&기초를 세우다
초석을 세우다|lay the foundations/jeter les bases&세계일주를 하다|go around the world/faire le tour du monde&세계화하다|globalise/mondialiser&세뇌시키다|indoctrinate/endoctriner&세다
헤아리다|count/compter&(무언가를 똑바로)
세우다|stand/lever&(건물 따위를)
세우다|set up/élever&건립하다|erect/ériger&창립하다
창설[창시]하다|found/fonder&설립[확립]하다
수립[정립]하다|establish/établir&섹스하다
성교하다|make love to/faire l'amour à&동침하다
잠자리를 갖다|sleep with/coucher avec&따먹다|screw/niquer&센세이션을 일으키다
신드롬을 일으키다|cause a sensation/faire sensation&소개하다|introduce/présenter&(기간 따위를)
지나다
도과하다|pass/passer&소관이다
관할이다|fall within the jurisdiction of/relever de&소식을 듣다
이야기를 듣다|hear/entendre dire&소용돌이치다
회오리치다|swirl/tourbillonner&소리를 내다|make a sound/faire un bruit&소비하다
소모하다|consume/consommer&소용 있다
쓸모 있다|serve/servir&(아무리 해도)
소용 없다
쓸모 없다|be no use/ne servir à rien&소홀히 하다
등한시 하다
도외시 하다
게을리 하다|neglect/négliger&(음식물을)
소화하다|digest/digérer&(일 따위를)
소화하다|assimilate/assimiler&(증인 따위를)
소환하다|summon/appeler&(영혼 따위를)
소환하다|summon/invoquer&속삭이다|whisper/chuchoter&속셈을 드러내다
본심을 드러내다|give oneself away/se trahir&속다
속아 넘어가다
낚이다|fall for/se tromper à&속셈을 알아채다|know one's game/voir venir&속이다|deceive/tromper&낚다|trick/feinter&기만하다|fool/abuser&손대다
건드리다|touch/toucher à&본국으로 송환하다|repatriate/rapatrier&솟다
솟아 있다|tower/se dresser&(액체 따위가)
치솟다
솟구치다|gush/jaillir&(가치 따위가)
치솟다
솟구치다|soar/s'envoler&쇠퇴하다|decline/décliner&쇼핑하다|do the shopping/faire les magasins&수색하다
뒤지다|search/fouiller&수술하다|operate on/opérer&수입하다|import/importer&수축시키다|contract/contracter&경련을 일으키다|convulse/convulser&대세이다
대유행하다|be all the rage/avoir le vent en poupe&가리다|cover/couvrir&수출하다|export/exporter&수확하다
거두다
거두어들이다|harvest/récolter&숙달하다
마스터하다|master/maîtriser&순환하다|circulate/circuler&술에서 깨다|sober up/dessoûler&숨기다
감추다|hide/cacher&은닉하다
은폐하다|conceal/dissimuler&은신시키다|hide/cacher&숨을 돌리다|get one's breath/reprendre haleine&숨을 쉬다
호흡하다|breathe/respirer&쉬다|rest/se reposer&휴식하다|take a break/faire une pause&스며들게 하다
배어들게 하다|impregnate/imprégner&스치다
스쳐 지나가다|brush past/frôler&슬프게 하다|sadden/peiner&상심시키다|grieve/chagriner&속상하게 하다|upset/désoler&가슴[마음] 아프게 하다|hurt one's heart/faire mal au cœur&감행하다
단행하다|risk/risquer&승인하다|approve/approuver&인가[재가]하다|authorise/autoriser&승낙하다|consent to/consentir à&비준하다|ratify/ratifier&승진시키다|promote/promouvoir&시끄럽게 하다|make a noise/faire du bruit&시도하다
해보다
하도록 하다|try/essayer&시연하다|demonstrate/démontrer&시위하다|demonstrate/manifester&시작하다|start/commencer&개시하다|launch/lancer&착수하다|undertake/entreprendre&출범하다|launch/démarrer&수행하다|perform/réaliser&(작전 따위를) 수행하다|conduct/mener&단행하다|execute/exécuter&돋우다|stimulate/stimuler&실행하다
실시하다
시행[집행]하다|execute/exécuter&(법률, 제도 따위를)
실행하다
실시하다
시행[집행]하다|bring into force/mettre en vigueur&시험하다|test/tester&실험하다|experiment/expérimenter&식히다
시원[상쾌]하게 하다|refresh/rafraîchir&신경쓰다|care about/s'occuper de&신경쓰지 않다
상관 않다
개의치 않다
아랑곳 않다|not mind/se moquer de&신고하다|report/signaler&(행정기관에) 신고하다|declare/déclarer&신청하다|apply for/s'inscrire à&싣다
적재하다|load/charger&(명단 따위에)
실리다
오르다
올라 있다|appear/figurer&실망시키다|disappoint/décevoir&실천하다|practise/pratiquer&실패하다
망하다|fail/manquer&하지 못하다|can't/ne pas arriver à&무산[불발]되다|abort/avorter&싫어하다
미워하다|hate/détester&혐오[증오]하다|execrate/exécrer&질색[질겁]하다|can't stand/avoir horreur de&심의하다
심사하다|deliberate over/délibérer de&심화하다
깊어지게 하다|deepen/approfondir&싸우게 하다
대결[대립]시키다|oppose/opposer&싸우다
다투다|fight/se battre&(큰 규모로)
싸우다
다투다|combat/combattre&싸우다
투쟁하다|struggle/lutter&말다툼하다
논쟁[언쟁]하다|argue/se disputer&대결[대립]하다|oppose/s'opposer à&쌓다|pile/empiler&구축하다|construct/construire&누적[축적]하다|cumulate/cumuler&썩다
상하다
부패하다|rot/pourrir&(벌 따위가) 쏘다|sting/piquer&쏘다
사격[발포]하다|shoot/tirer&저격하다|snipe/tirer au visé&(액체 따위를) 쏟다
엎다
엎지르다|spill/renverser&(무언가를 또는 누군가를)
쓰다
사용하다|use/utiliser&(무언가를)
쓰다
사용하다|employ/employer&다 쓰다
다 사용하다|run out of/épuiser&이용하다|take advantage of/profiter de&활용하다|exploit/exploiter&운용하다|manage/gérer&행사하다|exercise/exercer&응용[적용]하다|apply/appliquer&기절시키다|stun/évanouir&기절하다
쓰러지다|faint/faire un malaise&실신[졸도]하다|swoon/défaillir&정신[의식]을 잃다|lose consciousness/perdre connaissance&쓰다
적다|write/écrire&(휘갈겨)
쓰다
적다|scribble/griffonner&집필하다|write/écrire&작문하다|compose/composer&작성하다|draw up/rédiger&기록하다|record/enregistrer&기입[기재]하다|fill in/remplir&쓰이다
사용되다|be used for/servir à&(사회적으로 어떠한 말이)
쓰이다
사용[통용]되다|be said/se dire&씹다|chew/mâcher&아끼다|conserve/conserver&절약하다|save/économiser&아우르다|bring together/réunir&겸비하다|combine/cumuler&아첨하다
비위를 맞추다
환심을 사려고 하다|flatter/flatter&아프게 하다|hurt/faire mal à&아프다|hurt/avoir mal à&악수하다|shake hands/serrer la main&애태우다
안달하다|fret at/se tracasser pour&애간장을 태우다|eat one's heart out/se faire du mauvais sang&(알려주어)
안내하다|inform/informer&(직접 이끌어)
안내하다|guide/guider&안다
껴안다
포옹하다|hug/faire le câlin&안심시키다|reassure/rassurer&안도시키다|relieve/soulager&안정시키다|stabilise/stabiliser&앉다|sit/s'asseoir&자리하다|take a place/s'installer&착석하다|take a seat/siéger&숙지하다
알고 있다|be acquainted with/être au courant de&의식[자각]하다|be conscious of/prendre conscience de&알려주다|let know/laisser savoir&(계속, 나중에) 
알려주다|keep up to date about/tenir au courant de&대피하다
피난[피신]하다|take refuge/se réfugier&알리다
예고하다|announce/annoncer&연락하다|contact/contacter&보고하다|report/rapporter&통지하다
통고[고지]하다|notify/notifier&공지[공고]하다|announce/annoncer&맞다
알맞다
적절[적정]하다
적합[적당]하다|suit/convenir à&안성맞춤이다|fit the bill/faire l'affaire de&알아내다
생각해내다|find/trouver&알아보다
인식하다|recognise/reconnaître&지각하다
인지[감지]하다|perceive/percevoir&알아차리다|notice/remarquer&(정보 따위를) 알아보다|enquire about/s'informer de&(더, 자세히) 알아보다|learn more/en savoir long sur&(의중 따위를)
살피다|survey/sonder&알아서 하다|manage/se débrouiller&압도하다|overwhelm/surpasser&압수하다
압류하다|seize/saisir&몰수하다|confiscate/confisquer&암시하다|allude to/faire allusion à&시사하다
넌지시 말하다|suggest/suggérer&압착하다
짜다|press/presser&앞당기다|advance/avancer&앞장 서다
선두에 서다|take the head/prendre la tête&솔선수범하다|take the initiative/prendre l'initiative&앞서다
앞서가다
선행하다|go ahead of/devancer&앞지르다
추월하다|overtake/dépasser&약정하다
명문화하다|stipulate/stipuler&액화시키다|liquefy/liquéfier&약속에 나오지 않다|stand up/poser un lapin&약속을 잡다|make an appointment/donner un rendez-vous&약속하다|promise/promettre&확약[언약]하다|assure/assurer&약해지다
약화되다
쇠약해지다|weaken/s'affaiblir&감퇴하다|decline/décliner&(고추를 넣어)
양넘을 치다|spice/pimenter&(향신료를 넣어)
양념을 치다|spice/épicer&양립시키다|reconcile/concilier&(맥주를) 빚다
양조하다|brew/brasser&양심에 거리낌이 없다|have a clear conscience/avoir la conscience tranquille&양위하다
선위하다|abdicate/abdiquer&양치하다|brush one's teeth/se brosser les dents&양해를 구하다|ask for forgiveness/demander pardon&어긋나다
반하다
상반되다|be contrary to/contrarier&모순되다|contradict/contredire&어기다|break/manquer à&저버리다
지키지 않다|disobey/désobéir à&위반하다|violate/violer&위배하다|contravene/contrevenir à&어려운 처지에 놓여 있다|live on a razor's edge/être sur le fil du rasoir&(누군가에)
어울리다
매치가 되다|suit/aller à&(무언가에)
어울리다
매치가 되다|go with/aller à&(서로 잘)
어울리다
매치가 되다|fit together/faire la paire&어울리다
자주 만나다
어울려 다니다|hang out/fréquenter&어울리다
친하게 지내다
가까이 지내다|mix with/côtoyer&어제 오늘 일이 아니다|not start yesterday/ne pas dater d'hier&어지럽히다
혼란[교란]시키다|disturb/perturber&혼잡[난잡]하게 하다
혼선[체증]을 일으키다|congest/encombrer&억누르다|suppress/refouler&억제하다|repress/réprimer&압제하다|oppress/opprimer&진압[제압]하다|suppress/'soumettre&억압[탄압]하다|repress/réprimer&억류하다|detain/détenir&얻다|get/trouver&거두다|win/remporter&획득하다|obtain/obtenir&취득하다|acquire/acquérir&쟁취하다|conquer/conquérir&얻어주다
구해주다|procure/procurer&얼리다
동결시키다|freeze/geler&얼리다
냉동시키다|freeze/congeler&얽매다|tie down/attacher&구속[속박]하다|restrain/restreindre&얽히게 하다
엉클다
헝클다|tangle/emmêler&엉망진창으로 만들다
뒤죽박죽으로 만들다|muddle/embrouiller&숙청하다|purge/purger&없애다|remove/enlever&삭제하다|delete/supprimer&제거하다|eliminate/éliminer&소멸시키다|extinguish/anéantir&없어지다
사라지다
가시다
소멸하다|disappear/disparaître&흔적도 없이 사라지다
자취를 감추다|disappear into thin air/disparaître sans laisser de traces&없이 지내다|go without/se passer de&여겨지다|be thought of as/faire figure de&여행하다|travel/voyager&관광하다|go on a tour/faire du tourisme&역겹게 하다
혐오스럽게 하다|disgust/dégoûter&역할을 하다/구실을 하다|serve as/servir de&역행하다
배치되다|run counter to/aller à l'encontre de&엮다
땋다|braid/natter&연구하다|research/faire des recherches&전화하다|call/appeler&연루시키다
끌어들이다|implicate/impliquer&연루되다|get involved in/s'impliquer dans&연설하다|make a speech/faire un discours&(곡 따위를) 연주하다|play/jouer&(악기 따위를) 연주하다|play/jouer de&열다
개방하다
개통하다|open/ouvrir&개최하다|hold/tenir&열리다
개장하다
개막하다|open/ouvrir&개최되다|avoir lieu/take place&영감을 주다|inspire/inspirer&영위하다|lead/mener&영향을 미치다|influence/influencer&예민하다
신경이 날카롭다|be a bundle of nerves/vivre sur les nerfs&예방하다
방지하다|prevent/prévenir&예상하다|predict/prévoir&예정하다|plan/prévoir&예보하다|forecast/prévoir&예감하다|have a feeling/pressentir&예약하다|reserve/réserver&예견하다|foresee/prévoir&예언하다|predict/prédire&오게 하다
불러오다
모셔오다|fetch/faire venir&산(産)이다|come from/provenir de&오줌을 싸다|pee/faire pipi&오해하다
착각[오인]하다|misunderstand/mal comprendre&잘못 알다
잘못 생각하다|mistake/se tromper sur&(무언가를)
오르다
올라가다
올라오다|climb/monter&(무언가가)
오르다
올라가다
올라오다
상승하다|rise/monter&급등[폭등]하다|soar/s'envoler&올리다|raise/monter&인상하다|raise/relever&향상[상향]시키다|improve/améliorer&옮기다|move/porter&운반하다|transport/transporter&이전하다|transfer/transférer&이식하다|transplant/transplanter&옳다
일리가 있다|be right/avoir raison&옷을 입히다|dress/habiller&완성하다|complete/compléter&완료[완수]하다|accomplish/accomplir&왈가왈부하다
시비를 걸다
트집을 잡다|quibble/chicaner&왔다갔다하다|go back and forth/passer et repasser&왜곡하다
곡해하다|distort/déformer&외우다|learn by heart/apprendre par cœur&암기하다|memorise/mémoriser&외치다
소리치다
소리를 지르다|scream/crier&(감정이 격해지어)
외치다
소리치다
소리를 지르다|exclaim/s'exclamer&요기하다|grab a bite/casser la croûte&요리하다|cook/cuisiner&요약하다|resume/résumer&축약하다|abridge/abréger&간추리다|condense/condenser&용서하다|forgive/pardonner&(무언가가) 우선하다|predominate/prédominer&(누군가가) 우선하다
우선시하다|prioritise/privilégier&운동하다|do sport/faire du sport&운영하다|run/tenir&(특히 컴퓨터 시스템에서) 운영하다|operate/exploiter&경영하다|manage/gérer&운전하다|drive/conduire&운이 맞다|rhyme with/rimer avec&움직이게 하다
이동시키다|move/déplacer&움직이다
이동하다|move/bouger&웃다|laugh/rire&미소 짓다|smile/sourire&웃음을 터뜨리다|burst out laughing/avoir un éclat de rire&원망하다
탓하다
책임을 돌리다|blame/blâmer&원한을 품다|hold a grudge against/garder une dent contre&(꼭)
원하다
하고 싶다|be eager to/tenir à&(빨리)
원하다
하고 싶다|can't wait for/avoir hâte de&(죽을 정도로)
원하다
하고 싶다|be dying to/mourir d'envie de&위로하다|console/consoler&위안을 주다|comfort/réconforter&위를 날다
상공을 비행하다|fly over/survoler&위에 있다|sit on top of/surmonter&위조하다
변조[모조]하다|counterfeit/contrefaire&날조하다|fabricate/fabriquer&위치를 찾아내다|locate/localiser&위치하다
소재하다|be located/se situer&위험이 있다
우려가 있다|risk/risquer&위협하다
협박[겁박]하다|menace/menacer&유감스러워 하다
아쉬워 하다
섭섭해 하다
안타까워 하다|regret/regretter&유급하다|repeat the year/redoubler&유래하다
생기다|proceed from/procéder de&비롯하다
말미암다|result from/résulter de&파생되다|derive from/dériver de&기인하다
기원[원인]이다|be the origin of/être à l'origine de&유리하게 하다|favour/favoriser&유명해지다
이름을 날리다
세상에 알려지다|make a name for oneself/se faire connaître&(어느 상태로)
유지하다
계속 하다|keep/garder&(현상으로)
유지하다
계속 하다|maintain/maintenir&(좋은 상태로)
유지하다
계속 하다|keep up/entretenir&들다
홀리다|possess/posséder&상담하다
상의하다|consult/consulter&유통되다|circulate/circuler&유통시키다|circulate/faire circuler&(전염병 따위가) 유행하다|spread/se répandre&(인기를 얻어) 유행하다|be in fashion/être à la mode&유혹하다
현혹하다|seduce/séduire&매혹[매료]하다|fascinate/fasciner&유혹에 실패하다
꼬시지 못하다|get knocked back/se prendre un vent&음모를 꾸미다
결탁하다|conspire/conspirer&공모[모의]하다|plot/comploter&의견을 묻다
의견을 듣다|consult/consulter&논하다
논의[의논]하다|discuss/discuter&토론[토의]하다|debate/débattre&의무화하다|oblige/obliger&문제되다
대두되다|be on the rise/prendre de l'ampleur&문제삼다
대두시키다|call into question/remettre en question&뜻하다|mean/vouloir dire&의미하다|signify/signifier&의심의 여지가 없다|not be doubt/ne faire aucun doute&의심하다|doubt/douter de&의존하다|depend on/dépendre de&의지하다|count on/compter sur&으르렁거리다|bay/mugir&이겨내다
극복하다|overcome/franchir&이기다|win/gagner&승리[우승]하다|triumph/triompher&압승[완승]하다
대승을 거두다|vanquish/vaincre&이끌다|lead/entraîner&끌고 가다|drag/traîner&데려오다
데리고 오다|bring/amener&데려가다
데리고 가다|take/emmener&데리고 돌아오다|take back/ramener&인도[지도]하다|guide/guider&주도[리드]하다|lead/mener&이끌려 다니다|let oneself be pushed around/se laisser faire&이득을 보다|benefit from/bénéficier de&이루다
실현[구현]하다|realise/réaliser&이루어지다|be composed of/se composer de&구성되다|consist of/consister en&이륙하다|take off/décoller de&이발하다
머리를 하다|get one's hair cut/se faire coiffer&이사하다|move out/déménager&이야기하다
수다 떨다|talk/raconter&떠들다
잡담하다|chat/bavarder&대화하다|talk/se parler&계승하다
뒤를 잇다|succeed each other/se succéder&뒤따르다
잇따르다|follow/suivre&이어서 하다|pursue/poursuivre&계속[지속]하다|continue/continuer&이어지다|go on/se poursuivre&계속[지속]되다|continue/continuer&이어지다
연결되다|lead to/aboutir à&귀착[귀결]되다|lead to/aboutir à&이익이 되다
득이 되다|benefit/bénéficier à&이주하다|migrate/migrer&(타국에서) 이민오다|immigrate/immigrer&(타국으로) 이민가다|emigrate/émigrer&이중으로 하다|duplicate/doubler&이체하다|transfer/virer&송금하다|remit/remettre&이해하다|understand/comprendre&납득하다|understand/s'expliquer&파악하다|seize/saisir&알겠다|see/entendre&깨닫다
알게 되다|realise/réaliser&이행하다|fulfil/s'acquitter de&다하다|fulfil/remplir&이혼하다|divorce/divorcer de&(고기 따위를) 익히다|cook/cuire&익숙해지다|get used to/s'habituer à&인상을 주다|impress/impressionner&인쇄하다|print/imprimer&인수하다
인계받다|acquire/acquérir&인정하다|recognise./reconnaître&(유효료) 인정하다|validate/valider&수긍하다|grant/admettre&시인하다|confess/confesser&인정하지 않다|refuse/refuser&일 수 있다
일지도 모른다|may/se pouvoir&일그러뜨리다
비틀다
뒤틀다|distort/distordre&일반화하다
전반으로 확대하다|generalise/généraliser&대중화하다|popularise/populariser&보편화하다|universalise/universaliser&일보 직전에 있다|be on the brink of/être au bord de&일어나다
깨다|wake up/se réveiller&일어나다
생기다|happen/se passer&발생하다|occur/arriver&(어느 연대에)
일어나다
발생하다|date back to/dater de&발발하다|break out/se déclencher&일치하다
부합하다
들어맞다|correspond to/correspondre à&일하다|work/travailler&종사하다|work in/travailler dans&작업하다|work on/travailler sur&잃다|lose/perdre&길을 잃다|get lost/se perdre&분실[상실]하다|lose/perdre&갈아입다|change/se changer&(알맞은 복장으로) 갈아입다|dress up/se mettre en tenue&임대하다
세놓다|lease/louer&입금하다
예금[예치]하다|deposit/déposer&입다
착용하다|wear/porter&(벗지 않고) 입고 있다|keep on/garder&입대하다|join the military/rejoindre l'armee&입맛이 까다롭다|be a picky eater/faire la fine bouche&입사하다|enter a company/entrer dans une entreprise&입수하다
손에 넣다
손에 쥐다|come by/arracher&입원시키다|hospitalise/hospitaliser&잇다|join/joindre&연결하다|connect/connecter&잊다|forget/oublier&자극하다|stimulate/stimuler&흥분시키다|excite/exciter&열광시키다|fill with enthusiasm/enthousiasmer&(신경 따위를) 자극하다|irritate/irriter&자금을 대다
재정을 지원하다|finance/financer&자다|sleep/dormir&잠자리에 들다|go to bed/se coucher&자라다
성장[발육]하다|grow/grandir&자랑하다|boast of/exhiber&뽐내다
과시하다|show off/afficher&자부하다|pride oneself on/se vanter de&(돌 따위를) 깎다|cut/tailler&(껍질 따위를) 깎다|peel/éplucher&(특히 신체 따위를) 절단하다|amputate/amputer&자르다
썰다|cut/couper&다지다|chop/hacher&오리다
재단하다|cut/découper&잘라버리다
난도질하다|hack/charcuter&자리를 비우다|leave/quitter&자신의 생각을 나타내다|express oneself/s'exprimer&자생하다|grow wild/pousser à l'état sauvage&(협상 따위에서)
자신의 몸값을 잘 쳐서 받다|sell oneself well/se vendre bien&자위하다|masturbate/se masturber&자유화하다|liberalise/libéraliser&자칭하다|call oneself/se dire&작곡하다|compose/composer&작별하다|say goodbye to/dire adieu à&하직하다
마지막 인사를 하다|bid farewell/prendre congé de&작용하다
기능하다|function/fonctionner&잘난 체 하다|show oneself off/faire le malin&거드럭거리다
거드름 피우다|put on airs/faire des manières&잘 되어가다|go well/se passer bien&순조롭게 잘 풀리다|go smoothly/marcher comme sur des roulettes&잘못하다
실수[실책]하다|make a mistake/se tromper&(크게)
잘못하다
실수[실책]하다|make a gaffe/faire une gaffe&동결을 해제하다|unfreeze/dégeler&잠그다|lock/verrouiller&잠그다
담그다|soak/plonger&(생각 따위에) 잠기다|be lost in/plonger dans&(물에) 잠수하다|submerge/plonger&잡다
붙잡다|hold/tenir&(꽉, 와락)
잡다
붙잡다|seize/saisir&(범인 따위를)
잡다
붙잡다|catch/attraper&체포하다|arrest/arrêter&장기 자랑을 하다|do one's number/faire son numéro&장난치다|tease/taquiner&제 멋대로 하다
되는대로 하다|let oneself go/se laisser aller&제외하다
배제[퇴출]하다|exclude/exclure&제한하다
제약하다|limit/limiter&통제하다|control/contrôler&규제하다|regulate/réglementer&한정[국한]하다|confine/confiner&재개하다
속개[속행]하다|resume/reprendre&재다|take/prendre&측정[측량]하다|measure/mesurer&재론하다
번복하다|come back to/revenir sur&재밌게 하다
재미있게 하다|interest/intéresser&즐겁게 하다|entertain/réjouir&기분을 전환시키다|divert/divertir&즐기다
즐겁게 놀다
재밌게 놀다
재미있게 놀다|enjoy/s'amuser&재발하다|recur/se reproduire&(에너지 따위를) 재생하다|renew/renouveler&(소리 따위를) 재생하다|play/reproduire&재촉하다
독촉하다|press/presser&재우다|get to sleep/endormir&재편하다|reorganise/réorganiser&재현하다|reproduce/reproduire&재확인하다|reaffirm/réaffirmer&재활용하다|recycle/recycler&저장하다
보관[간직]하다|conserve/conserver&비축하다|reserve/réserver&저지[제지]하다|stand in the way of/faire barrage à&제동을 걸다|put a brake on/freiner&뒤바꾸다
거꾸로 하다|reverse/renverser&저주하다|curse/maudire&저지르다
범하다|commit/commettre&저축하다|save/économiser&저항하다|resist/résister à&대항하다|oppose/s'opposer à&반항하다
대들다|revolt/se révolter contre&적시다
젖게 하다|wet/tremper&적응하다|adapt to/s'adapter à&전념하다|be dedicated to/s'occuper de&열중하다|be absorbed in/s'absorber dans&심취하다
푹 빠지다|get a passion for/s'engouer de&골몰[몰두]하다|be immersed in/s'immerger dans&전하다
전달하다|transmit/transmettre&관계를 끊다
절연하다|break up with/rompre avec&의절하다|disown/renier&거론하다|mention/mentionner&보여주다
제시하다|present/présenter&심문하다|interrogate/interroger&기부하다
기증하다|donate/faire un don&베풀다|grant/octroyer&하사하다|bestow/décerner&대주다
지원하다
공급[조달]하다|provide/fournir&(식당에서)
시키다
주문하다|order/commander&(배달을)
시키다
주문하다|have delivered/se faire livrer&머뭇거리다
주춤거리다|dither/tergiverser&자살하다|suicide/se suicider&목숨을 끊다|take one's life/mettre fin à sa vie&가리키다
지목하다|indicate/indiquer&부끄럽게 하다
창피를 주다
수치스럽게 하다|shame/faire honte à&부끄럽다
창피하다
수치스럽다|be ashamed of/avoir honte de&아닌가 하고 생각하다|suspect/soupçonner&얼마든지 있다
부족하지 않다
모자르지 않다|not lack anything/ne rien manquer&취향에 맞다|be to one's taste/être au goût de&덕분이다
덕택이다|owe/devoir&분출하다|spurt up/rejaillir&(용암이) 분출하다|erupt/entrer en éruption&교류하다|exchange/échanger&왕래하다|circulate/circuler&방책을 택하다
전술로 삼다|play the card/jouer la carte&단념하다|give up/délaisser&체념하다|resign oneself/se faire une raison&관두다
집어치우다|drop/laisser tomber&(하기 싫은 일을) 떠맡다|get stuck with/se taper&지랄하다|go nut/péter un plomb&비틀거리다
후들거리다|stagger/vaciller&전시하다|expose/exposer&전환시키다
변환시키다|convert/reconvertir&절망하다|despair/se désespérer&점을 찍다|dot/mettre un point&점점 더 나빠지다|go from bad to worse/aller de mal en pis&(장소를)
점찍어 두다
알아 두다|locate/repérer&접다|fold/piler&(지점, 국면 따위에) 접어들다|enter/entrer&(경계 또는 가장자리를 이루며) 접하다|border/border&정당화하다|justify/justifier&정리하다
정돈하다|tidy/ranger&청산하다|liquidate/liquider&확대하다|amplify/amplifier&정보를 제공하다|inform/informer&정복하다|conquest/conquérir&정상화하다|normalise/normaliser&정신을 차리다|come to one's senses/reprendre ses esprits&제정신으로 돌아오다|return to oneself/revenir à soi&정주행하다
직진하다|go straight/aller tout droit&정주행하다
몰아서 보다|binge-watch/faire percer&정진하다
끝까지 하다
끈질기게 하다|persevere in/persévérer dans&정착하다
자리잡다|settle down/s'installer&정책을 바꾸다|change course/changer de cap&정하다
결정하다|decide/décider&(직권으로)
정하다
결정하다|decree/décréter&확정하다|determine/déterminer&정하다|fix/fixer&배정하다|assign/assigner&제정하다|enact/établir&지정하다|designate/désigner&정해놓다
정해두다|destine/destiner&제기하다|pose/poser&제목을 붙이다|entitle/intituler&제시하다
제안하다
제의[건의]하다|propose/proposer&제조하다
제작하다|produce/produire&(대량으로)
제조하다
제작하다|manufacture/manufacturer&조사하다
수사하다|enquire into/enquêter sur&조심하다|be careful of/faire attention à&경계하다|be on guard for/se garder de&주의[유의]하다|note/noter&조작된 정보를 제공하다|misinform/désinformer&조정하다
중재하다|arbitrate/arbitrer&화해시키다|reconcile/réconcilier&절충[타협]하다|compromise/faire des compromis&조직하다|organise/organiser&(각 부분이 조화를 이루도록) 조직하다|coordinate/coordonner&(대대적으로) 조직하다|orchestrate/orchestrer&조치하다
조처하다|take measures/prendre des mesures&존중하다
존경[공경]하다|respect/respecter&존재하다
실재[현존]하다|exist/exister&졸업하다|graduate/finir ses études&좁히다|narrow/rétrécir&종속시키다|subordinate/subordonner&예속시키다|subjugate/assujettir&좇다
추구하다|pursue/poursuivre&좋다
도움이 되다|do good/faire du bien&덕을 보다|favour/servir&좋아지다
나아지다
괜찮아지다|get better/aller mieux&호전되다|improve/s'arranger&(열렬히)
좋아하다
사랑하다|be fond of/affectionner&애지중지하다
소중히 여기다|cherish/chérir&좋을 대로 하다|do as it pleases/faire ce que bon lui semble&(누군가를) 좌절시키다|frustrate/frustrer&(무언가를) 좌절시키다|disconcert/déconcerter&죄다
조이다|tighten/serrer&죄를 짓다|sin/pécher&죄의식을 느끼게 하다|make feel guilty/culpabiliser&제공하다|offer/offrir&부여하다|accord/accorder&수여하다|confer/conférer&주둔시키다|station/baser&주목하다
눈여겨보다|pay attention to/prêter attention à&주장하다|assert/affirmer&요구[요청]하다|ask/demander&(강하게) 요구[요청]하다|demand/exiger&주차하다|park/stationner&사망하다
작고[별세]하다|pass away/décéder&숨지다
숨을 거두다|breathe one's last/rendre l'âme&운명하다
명을 다하다|pass away/trépasser&뒤지다|croak/claquer&(수많은 사람을) 죽이다
살해하다|decimate/décimer&암살하다|assassinate/assassiner&교살하다|strangle/étrangler&독살하다|poison/empoisonner&사살하다|kill/abattre&살인하다|murder/tuer&도살[도축]하다|slaughter/abattre&줄이다|reduce/réduire&축소하다|reduce/réduire&단축하다|reduce/réduire&삭감하다
감축[감산]하다|reduce/réduire&감소시키다|decrease/diminuer&줍다|pick/ramasser&지나치게 하다
너무 많이 하다|abuse/abuser de&중독시키다|poison/empoisonner&중시하다
중요시하다|value/valoriser&중요하다|matter/importer&중화하다|neutralise/neutraliser&즉위시키다
옹립하다|enthrone/introniser&즉흥적으로 하다
즉석에서 하다|improvise/improviser&증명하다, 입증하다|prove/prouver&논증하다|demonstrate/démontrer&증빙하다
증거를 보이다|prove/justifier&증언하다|testify/témoigner&지겹게 하다
싫증나게 하다
지루[심심]하게 하다|bore/ennuyer&지겹다
질리다
지긋지긋하다|be fed up/en avoir assez&신물이 나다|have had it/en avoir ras-le-bol&지겹지 않다
질리지 않다
지긋지긋하지 않다|can't get enough of/ne pas pouvoir avoir assez de&지급하다
발급하다
교부[발부]하다|issue/délivrer&지껄이다|blather/blablater&씨부리다|come out with/sortir&개소리하다|talk bullshit/déconner&지나다
지나가다
통과[통행]하다|pass/passer&건너다
횡단하다|cross/traverser&지나치다|pass by/passer devant&지난 일을 잊다|put behind one/tourner la page&지다|lose/perdre&패배하다|suffer a defeat/essuyer une défaite&(천체가) 지다|fall/tomber&저물다|decline/décliner&지배를 받다
치하에 있다|be under one's control/passer sous contrôle&지배하다|dominate/dominer&군림하다|reign/régner&다스리다
통치하다|govern/gouverner&(직위, 시험 따위에) 지원하다|apply for/postuler à&지우다|erase/effacer&지출하다|expend/dépenser&지치게 하다
힘들게 하다
피곤하게 하다|tire/fatiguer&탈진시키다
기진맥진하게 다|exhaust/exténuer&녹초가 되게 하다|weary/épuiser&지치다
맥 빠지다
기운이 다 빠지다|go limp/avoir un coup de mou&지켜보다
관찰하다|observe/observer&감시하다|monitor/surveiller&관망하다|wait and see/venir voir&지키다|guard/garder&보호[비호]하다|protect/protéger&준수하다|respect/respecter&수호하다|defend/défendre&보존[보전]하다|preserve/préserver&진군하다
진격하다|march/marcher&행군[행진]하다|march/marcher&(열을 지어) 행군[행진]하다|parade/défiler&진보하다
진전을 보다|progress/progresser&진정시키다
달래다|calm down/calmer&완화하다|alleviate/atténuer&가라앉히다|appease/apaiser&누그러뜨리다|soften/faire craquer&진찰받다|consult a doctor/consulter un médecin&(경기 따위에)
진출하다
출전하다|qualify for/se qualifier en&진행되다
진척되다|progress/progresser&진행을 맡다
사회를 맡다|present/animer&주재[주관]하다|preside at/présider&진행하다
진척시키다|proceed/avancer&질식시키다
숨막히게 하다|stifle/étouffer&집단화하다|collectivise/collectiviser&집권하다|come to power/arriver au pouvoir&집중이 안 되게 하다
주의를 흩뜨리다
주의를 산만하게 하다|distract/distraire&집중시키다|concentrate/concentrer&집약시키다|integrate/intégrer&집착하다
집념하다|stick to/s'attacher à&매달리다|cling to/s'accrocher à&짓누르다
압박하다
압력을 가하다|press/presser&(건물을) 짓다|build/bâtir&건설[건축]하다|construct/construire&(문장, 글 따위를) 짓다|compose/composer&(문장, 글 따위를) 구성하다|construct/construire&짖다|bark/aboyer&울부짖다|howl/hurler&포효하다|roar/rugir&짙게 하다
빽빽[조밀]하게 하다|densify/densifier&(베, 거미줄 따위를)|짜다&